adresem	adres	subst:sg:inst:m3
ambasadą	ambasada	subst:sg:inst:f
ammanem	-	-
apelem	apel	subst:sg:inst:m3
budowę	budowa	subst:sg:acc:f
budynek	budynek	subst:sg:acc:m3+subst:sg:nom:m3
budynkami	budynek	subst:pl:inst:m3
całością	całość	subst:sg:inst:f
dokumentem	dokument	subst:sg:inst:m3
dowództwem	dowództwo	subst:sg:inst:n2
dozorem	dozór	subst:sg:inst:m3
fiatem	fiat	subst:sg:inst:m2
gniazda	gniazdo	subst:pl:acc:n2+subst:pl:nom:n2+subst:pl:voc:n2+subst:sg:gen:n2
gołym	goły	adj:pl:dat:m1.m2.m3.f.n1.n2.p1.p2.p3:pos+adj:sg:inst:m1.m2.m3.n1.n2:pos+adj:sg:loc:m1.m2.m3.n1.n2:pos+subst:pl:dat:m1+subst:sg:inst:m1+subst:sg:loc:m1
gołym	goła	subst:pl:dat:f
groznym	-	-
głosowanie	głosowanie	subst:sg:acc:n2+subst:sg:nom:n2+subst:sg:voc:n2
głosowanie	głosować	ger:sg:nom.acc:n2:imperf:aff:nonrefl
haslem	-	-
hasłem	hasło	subst:sg:inst:n2
jaszczurami	jaszczur	subst:pl:inst:m2+subst:pl:inst:m3
jego	on	ppron3:sg:acc:m1.m2.m3:ter:akc:npraep+ppron3:sg:gen:m1.m2.m3:ter:akc:npraep+ppron3:sg:gen:n1.n2:ter:akc:npraep
jej	jej	interj
jej	on	ppron3:sg:dat:f:ter:akc.nakc:npraep+ppron3:sg:gen:f:ter:akc.nakc:npraep
jeszcze	jeszcze	qub
kable	kabel	depr:pl:nom:m2+depr:pl:voc:m2+subst:pl:acc:m3+subst:pl:nom:m1+subst:pl:nom:m3+subst:pl:voc:m1+subst:pl:voc:m3
każdą	każdy	adj:sg:acc:f:pos+adj:sg:inst:f:pos
kierownictwem	kierownictwo	subst:sg:inst:n2
kierunkiem	kierunek	subst:sg:inst:m3
koniec	koniec	subst:sg:acc:m3+subst:sg:nom:m3
konsulatem	konsulat	subst:sg:inst:m3
kopalnią	kopalnia	subst:sg:inst:f
listem	list	subst:sg:inst:m3
mont	-	-
mostem	most	subst:sg:inst:m3
nazwa	nazwa	subst:sg:nom:f
nazwą	nazwa	subst:sg:inst:f
nazwą	nazwać	verb:fin:pl:ter:perf:refl.nonrefl
numerem	numer	subst:sg:inst:m3
obiema	oba	num:pl:inst:f:congr
obrady	obrady	subst:pl:acc:p3+subst:pl:nom:p3+subst:pl:voc:p3
obrady	obrada	subst:pl:acc:f+subst:pl:nom:f+subst:pl:voc:f+subst:sg:gen:f
opieką	opieka	subst:sg:inst:f
opieką	opiec	verb:fin:pl:ter:perf:refl.nonrefl
orzecznictwo	orzecznictwo	subst:sg:acc:n2+subst:sg:nom:n2+subst:sg:voc:n2
paryżem	-	-
petycją	petycja	subst:sg:inst:f
policjanta	policjant	subst:sg:acc:m1+subst:sg:gen:m1
pomnikiem	pomnik	subst:sg:inst:m3
poncjuszem	-	-
postacią	postać	subst:sg:inst:f
pozorem	pozór	subst:sg:inst:m3
presją	presja	subst:sg:inst:f
pretekstem	pretekst	subst:sg:inst:m3
przewodnictwem	przewodnictwo	subst:sg:inst:n2
przykrywką	przykrywka	subst:sg:inst:f
rządami	rząd	subst:pl:inst:m3
rządami	rządy	subst:pl:inst:p3
siedzibą	siedziba	subst:sg:inst:f
skargą	skarga	subst:sg:inst:f
stołem	stół	subst:sg:inst:m3
swoim	swoje	subst:pl:dat:n2+subst:sg:inst:n2+subst:sg:loc:n2
swoim	swój	adj:pl:dat:m1.m2.m3.f.n1.n2.p1.p2.p3:pos+adj:sg:inst:m1.m2.m3.n1.n2:pos+adj:sg:loc:m1.m2.m3.n1.n2:pos
swoją	swoić	verb:fin:pl:ter:imperf:refl.nonrefl
swoją	swój	adj:sg:acc:f:pos+adj:sg:inst:f:pos
tablicą	tablica	subst:sg:inst:f
tarnopolem	-	-
tel	telefon	brev:pun
tym	tym	adv+conj
tym	ten	adj:pl:dat:m1.m2.m3.f.n1.n2.p1.p2.p3:pos+adj:sg:inst:m1.m2.m3.n1.n2:pos+adj:sg:loc:m1.m2.m3.n1.n2:pos
tym	to	subst:sg:inst:n2+subst:sg:loc:n2
tytułem	tytuł	subst:sg:inst:m3
urzedami	-	-
uwage	-	-
uwagę	uwaga	subst:sg:acc:f
warszawskim	warszawski	adj:pl:dat:m1.m2.m3.f.n1.n2.p1.p2.p3:pos+adj:sg:inst:m1.m2.m3.n1.n2:pos+adj:sg:loc:m1.m2.m3.n1.n2:pos
warszawą	warszawa	subst:sg:inst:f
warunkiem	warunek	subst:sg:inst:m3
waszyngtonem	-	-
wezwaniem	wezwanie	subst:sg:inst:n2
wezwaniem	wezwać	ger:sg:inst:n2:perf:aff:refl.nonrefl
wnioskiem	wniosek	subst:sg:inst:m3
wodami	woda	subst:pl:inst:f
wpływem	wpływ	subst:sg:inst:m3
wymownym	wymowny	adj:pl:dat:m1.m2.m3.f.n1.n2.p1.p2.p3:pos+adj:sg:inst:m1.m2.m3.n1.n2:pos+adj:sg:loc:m1.m2.m3.n1.n2:pos
wysokim	wysoki	adj:pl:dat:m1.m2.m3.f.n1.n2.p1.p2.p3:pos+adj:sg:inst:m1.m2.m3.n1.n2:pos+adj:sg:loc:m1.m2.m3.n1.n2:pos
wzgledem	-	-
względem	względem	prep:gen
względem	wzgląd	subst:sg:inst:m3
zarzutem	zarzut	subst:sg:inst:m3
ziemią	ziemia	subst:sg:inst:f
znakiem	znak	subst:sg:inst:m3
ścianą	ściana	subst:sg:inst:f
