akcji	akcja	subst:pl:gen:f+subst:sg:dat:f+subst:sg:gen:f+subst:sg:loc:f
aktów	akt	subst:pl:gen:m3
albańczyków	-	-
aleksandra	-	-
alpejskiego	alpejski	adj:sg:acc:m1.m2:pos+adj:sg:gen:m1.m2.m3.n1.n2:pos
analogicznego	analogiczny	adj:sg:acc:m1.m2:pos+adj:sg:gen:m1.m2.m3.n1.n2:pos
apokaliptycznej	apokaliptyczny	adj:sg:dat:f:pos+adj:sg:gen:f:pos+adj:sg:loc:f:pos
aresztu	areszt	subst:sg:gen:m3
austriackiego	austriacki	adj:sg:acc:m1.m2:pos+adj:sg:gen:m1.m2.m3.n1.n2:pos
austrii	-	-
awpl	-	-
aws	-	-
awsowskich	-	-
azerbejdżanu	-	-
azji	-	-
bangladeszu	-	-
banku	bank	subst:sg:gen:m3+subst:sg:loc:m3+subst:sg:voc:m3
bałkańskiej	bałkański	adj:sg:dat:f:pos+adj:sg:gen:f:pos+adj:sg:loc:f:pos
bałtyku	-	-
belleville	-	-
benalmadena	-	-
berlińskiego	berliński	adj:sg:acc:m1.m2:pos+adj:sg:gen:m1.m2.m3.n1.n2:pos
betlejem	-	-
bezradności	bezradność	subst:pl:acc:f+subst:pl:gen:f+subst:pl:nom:f+subst:pl:voc:f+subst:sg:dat:f+subst:sg:gen:f+subst:sg:loc:f+subst:sg:voc:f
białego	biały	adj:sg:acc:m1.m2:pos+adj:sg:gen:m1.m2.m3.n1.n2:pos+subst:sg:acc:m1
białego	biały	subst:sg:gen:m1
biernego	bierny	adj:sg:acc:m1.m2:pos+adj:sg:gen:m1.m2.m3.n1.n2:pos
big	biga	subst:pl:gen:f
biura	biuro	subst:pl:acc:n2+subst:pl:nom:n2+subst:pl:voc:n2+subst:sg:gen:n2
blisko	blisko	adv:pos+qub
bojkotu	bojkot	subst:sg:gen:m3
bolidów	bolid	subst:pl:gen:m3
bosni	-	-
bośniackich	bośniacki	adj:pl:acc:m1.p1:pos+adj:pl:gen:m1.m2.m3.f.n1.n2.p1.p2.p3:pos+adj:pl:loc:m1.m2.m3.f.n1.n2.p1.p2.p3:pos
bośniackiego	bośniacki	adj:sg:acc:m1.m2:pos+adj:sg:gen:m1.m2.m3.n1.n2:pos
bram	bram	subst:sg:acc:m3+subst:sg:nom:m3
bram	brama	subst:pl:gen:f
branży	branża	subst:sg:dat:f+subst:sg:gen:f+subst:sg:loc:f
bratysławy	-	-
brytyjki	-	-
budynku	budynek	subst:sg:gen:m3+subst:sg:loc:m3+subst:sg:voc:m3
bukaresztu	-	-
bundestagu	-	-
celów	cel	subst:pl:gen:m3
cen	cena	subst:pl:gen:f
centrum	centrum	subst:sg:acc:n2+subst:sg:dat:n2+subst:sg:gen:n2+subst:sg:inst:n2+subst:sg:loc:n2+subst:sg:nom:n2+subst:sg:voc:n2
cerdanyola	-	-
chicago	-	-
chorwacji	-	-
chrystusowego	chrystusowy	adj:sg:acc:m1.m2:pos+adj:sg:gen:m1.m2.m3.n1.n2:pos
chuliganów	chuligan	subst:pl:acc:m1+subst:pl:gen:m1
chwili	chwila	subst:pl:gen:f+subst:sg:dat:f+subst:sg:gen:f+subst:sg:loc:f
cieplejszych	ciepły	adj:pl:acc:m1.p1:com+adj:pl:gen:m1.m2.m3.f.n1.n2.p1.p2.p3:com+adj:pl:loc:m1.m2.m3.f.n1.n2.p1.p2.p3:com
cio	-	-
cisy	cis	subst:pl:acc:m3+subst:pl:nom:m3+subst:pl:voc:m3
cwiercfinalow	-	-
cwiercfinalu	-	-
cwiercfinaly	-	-
cywilnych	cywilny	adj:pl:acc:m1.p1:pos+adj:pl:gen:m1.m2.m3.f.n1.n2.p1.p2.p3:pos+adj:pl:loc:m1.m2.m3.f.n1.n2.p1.p2.p3:pos
czasu	czas	subst:sg:gen:m3
czeczenii	-	-
czerwca	czerwiec	subst:sg:acc:m2
czerwca	czerwiec	subst:sg:gen:m2+subst:sg:gen:m3
czlonkostwa	-	-
czlonkow	-	-
czolowej	-	-
czterech	cztery	num:pl:acc:m1:rec+num:pl:gen.loc:m1.m2.m3.n2.f:congr+num:pl:nom.voc:m1:rec
czwartkowego	czwartkowy	adj:sg:acc:m1.m2:pos+adj:sg:gen:m1.m2.m3.n1.n2:pos
czwartku	czwartek	subst:sg:gen:m3+subst:sg:loc:m3+subst:sg:voc:m3
czwórki	czwórka	subst:pl:acc:f+subst:pl:nom:f+subst:pl:voc:f+subst:sg:gen:f
czynienia	czynienie	subst:pl:acc:n2+subst:pl:nom:n2+subst:pl:voc:n2+subst:sg:gen:n2
czynienia	czynić	ger:sg:gen:n2:imperf:aff:refl.nonrefl
członkostwa	członkostwo	subst:pl:acc:n2+subst:pl:nom:n2+subst:pl:voc:n2+subst:sg:gen:n2
dalszej	daleki	adj:sg:dat:f:com+adj:sg:gen:f:com+adj:sg:loc:f:com
dalszych	daleki	adj:pl:acc:m1.p1:com+adj:pl:gen:m1.m2.m3.f.n1.n2.p1.p2.p3:com+adj:pl:loc:m1.m2.m3.f.n1.n2.p1.p2.p3:com
darmowych	darmowy	adj:pl:acc:m1.p1:pos+adj:pl:gen:m1.m2.m3.f.n1.n2.p1.p2.p3:pos+adj:pl:loc:m1.m2.m3.f.n1.n2.p1.p2.p3:pos
deczyzji	-	-
deformacji	deformacja	subst:pl:gen:f+subst:sg:dat:f+subst:sg:gen:f+subst:sg:loc:f
delegatów	delegat	subst:pl:acc:m1+subst:pl:gen:m1
delhi	-	-
deutsche	-	-
dialogu	dialog	subst:sg:gen:m3+subst:sg:loc:m3+subst:sg:voc:m3
dniowej	dniowy	adj:sg:dat:f:pos+adj:sg:gen:f:pos+adj:sg:loc:f:pos
dobrego	dobre	subst:sg:gen:n2
dobrego	dobry	adj:sg:acc:m1.m2:pos+adj:sg:gen:m1.m2.m3.n1.n2:pos+subst:sg:acc:m1+subst:sg:gen:m1+subst:sg:gen:m3
dochodzenia	dochodzenie	subst:pl:acc:n2+subst:pl:nom:n2+subst:pl:voc:n2+subst:sg:gen:n2
dochodzenia	dochodzić	ger:sg:gen:n2:imperf:aff:nonrefl+ger:sg:gen:n2:perf:aff:nonrefl
dokonania	dokonanie	subst:pl:acc:n2+subst:pl:nom:n2+subst:pl:voc:n2+subst:sg:gen:n2
dokonania	dokonać	ger:sg:gen:n2:perf:aff:refl.nonrefl
dolara	dolar	subst:sg:acc:m2+subst:sg:gen:m2
doliny	dolina	subst:pl:acc:f
doliny	dolina	subst:pl:nom:f
doliny	dolina	subst:pl:voc:f
doliny	dolina	subst:sg:gen:f
domu	dom	subst:sg:gen:m3
domu	dom	subst:sg:loc:m3+subst:sg:voc:m3
domów	domówić	verb:impt:sg:sec:perf:refl.nonrefl
domów	dom	subst:pl:gen:m3
domów	domowić	verb:impt:sg:sec:perf:refl.nonrefl
dowolnej	dowolny	adj:sg:dat:f:pos+adj:sg:gen:f:pos+adj:sg:loc:f:pos
dramatopisarki	dramatopisarka	subst:pl:acc:f+subst:pl:nom:f+subst:pl:voc:f+subst:sg:gen:f
drugiej	drugi	adj:sg:dat:f:pos+adj:sg:gen:f:pos+adj:sg:loc:f:pos
drugiej	druga	subst:sg:dat:f+subst:sg:gen:f+subst:sg:loc:f
ducha	duch	subst:sg:acc:m2+subst:sg:gen:m2
duchownych	duchowny	adj:pl:acc:m1.p1:pos+adj:pl:gen:m1.m2.m3.f.n1.n2.p1.p2.p3:pos+adj:pl:loc:m1.m2.m3.f.n1.n2.p1.p2.p3:pos+subst:pl:acc:m1+subst:pl:gen:m1+subst:pl:loc:m1
dunajueksperci	-	-
dużego	duży	adj:sg:acc:m1.m2:pos+adj:sg:gen:m1.m2.m3.n1.n2:pos
dwoch	-	-
dwudziestu	dwadzieścia	num:pl:acc:m1:rec+num:pl:gen.dat.inst.loc:m1.m2.m3.f.n2:congr+num:pl:nom.voc:m1:rec
dwóch	dwa	num:pl:acc:m1:rec+num:pl:gen.loc:m1.m2.m3.n2.f:congr+num:pl:nom.voc:m1:rec
dymisji	dymisja	subst:pl:gen:f+subst:sg:dat:f+subst:sg:gen:f+subst:sg:loc:f
dyskusji	dyskusja	subst:pl:gen:f+subst:sg:dat:f+subst:sg:gen:f+subst:sg:loc:f
dyspozycji	dyspozycja	subst:pl:gen:f+subst:sg:dat:f+subst:sg:gen:f+subst:sg:loc:f
działania	działanie	subst:pl:acc:n2+subst:pl:nom:n2+subst:pl:voc:n2+subst:sg:gen:n2
działania	działać	ger:sg:gen:n2:imperf:aff:nonrefl
działań	działanie	subst:pl:gen:n2
dzisiaj	dzisiaj	adv+subst:pl:acc:n2+subst:pl:dat:n2+subst:pl:gen:n2+subst:pl:inst:n2+subst:pl:loc:n2+subst:pl:nom:n2+subst:pl:voc:n2+subst:sg:acc:n2+subst:sg:dat:n2+subst:sg:gen:n2+subst:sg:inst:n2+subst:sg:loc:n2+subst:sg:nom:n2+subst:sg:voc:n2
dziś	dziś	adv+subst:pl:acc:n2+subst:pl:dat:n2+subst:pl:gen:n2+subst:pl:inst:n2+subst:pl:loc:n2+subst:pl:nom:n2+subst:pl:voc:n2+subst:sg:acc:n2+subst:sg:dat:n2+subst:sg:gen:n2+subst:sg:inst:n2+subst:sg:loc:n2+subst:sg:nom:n2+subst:sg:voc:n2
edukacji	edukacja	subst:pl:gen:f+subst:sg:dat:f+subst:sg:gen:f+subst:sg:loc:f
egiptu	-	-
ej	ej	interj
eksportu	eksport	subst:sg:gen:m3
ekstraklasy	ekstraklasa	subst:pl:acc:f+subst:pl:nom:f+subst:pl:voc:f+subst:sg:gen:f
el	el	subst:pl:acc:n2+subst:pl:dat:n2+subst:pl:gen:n2+subst:pl:inst:n2+subst:pl:loc:n2+subst:pl:nom:n2+subst:pl:voc:n2+subst:sg:acc:n2+subst:sg:dat:n2+subst:sg:gen:n2+subst:sg:inst:n2+subst:sg:loc:n2+subst:sg:nom:n2+subst:sg:voc:n2
eliminacyjnych	eliminacyjny	adj:pl:acc:m1.p1:pos+adj:pl:gen:m1.m2.m3.f.n1.n2.p1.p2.p3:pos+adj:pl:loc:m1.m2.m3.f.n1.n2.p1.p2.p3:pos
emigracji	emigracja	subst:pl:gen:f+subst:sg:dat:f+subst:sg:gen:f+subst:sg:loc:f
emisji	emisja	subst:pl:gen:f+subst:sg:dat:f+subst:sg:gen:f+subst:sg:loc:f
emu	emu	subst:pl:acc:m2+subst:pl:acc:n2+subst:pl:dat:m2+subst:pl:dat:n2+subst:pl:gen:m2+subst:pl:gen:n2+subst:pl:inst:m2+subst:pl:inst:n2+subst:pl:loc:m2+subst:pl:loc:n2+subst:pl:nom:m2+subst:pl:nom:n2+subst:pl:voc:m2+subst:pl:voc:n2+subst:sg:acc:m2+subst:sg:acc:n2+subst:sg:dat:m2+subst:sg:dat:n2+subst:sg:gen:m2+subst:sg:gen:n2+subst:sg:inst:m2+subst:sg:inst:n2+subst:sg:loc:m2+subst:sg:loc:n2+subst:sg:nom:m2+subst:sg:nom:n2+subst:sg:voc:m2+subst:sg:voc:n2
epizodu	epizod	subst:sg:gen:m3
eskalacji	eskalacja	subst:pl:gen:f+subst:sg:dat:f+subst:sg:gen:f+subst:sg:loc:f
euro	euro	subst:pl:acc:n2+subst:pl:dat:n2+subst:pl:gen:n2+subst:pl:inst:n2+subst:pl:loc:n2+subst:pl:nom:n2+subst:pl:voc:n2+subst:sg:acc:n2+subst:sg:dat:n2+subst:sg:gen:n2+subst:sg:inst:n2+subst:sg:loc:n2+subst:sg:nom:n2+subst:sg:voc:n2
europejskiej	europejski	adj:sg:dat:f:pos+adj:sg:gen:f:pos+adj:sg:loc:f:pos
europy	europ	subst:pl:acc:m3+subst:pl:nom:m3+subst:pl:voc:m3
fbi	-	-
federacji	federacja	subst:pl:gen:f+subst:sg:dat:f+subst:sg:gen:f+subst:sg:loc:f
filmu	film	subst:sg:gen:m3
filmów	film	subst:pl:gen:m3
finalowego	-	-
finalu	-	-
finansowania	finansować	ger:sg:gen:n2:imperf:aff:refl.nonrefl
finału	finał	subst:sg:gen:m3
finałów	finał	subst:pl:gen:m3
firm	firma	subst:pl:gen:f
fixingu	fixing	subst:sg:gen:m3+subst:sg:loc:m3+subst:sg:voc:m3
flers	-	-
forda	ford	subst:sg:acc:m2
forda	ford	subst:sg:gen:m2
forum	forum	subst:sg:acc:n2+subst:sg:dat:n2+subst:sg:gen:n2+subst:sg:inst:n2+subst:sg:loc:n2+subst:sg:nom:n2+subst:sg:voc:n2
francuskiego	francuski	adj:sg:acc:m1.m2:pos+adj:sg:gen:m1.m2.m3.n1.n2:pos+subst:sg:gen:m3
frankfurtu	-	-
funduszu	fundusz	subst:sg:gen:m3+subst:sg:loc:m3+subst:sg:voc:m3
funduszy	fundusz	subst:pl:gen:m3
gier	gra	subst:pl:gen:f
gmin	gmin	subst:sg:acc:m3+subst:sg:nom:m3
gmin	gmina	subst:pl:gen:f
gniezna	-	-
godności	godność	subst:pl:acc:f+subst:pl:gen:f+subst:pl:nom:f+subst:pl:voc:f+subst:sg:dat:f+subst:sg:gen:f+subst:sg:loc:f+subst:sg:voc:f
godz	godzina	brev:pun
godziny	godzina	subst:pl:acc:f+subst:pl:nom:f+subst:pl:voc:f+subst:sg:gen:f
grand	grand	subst:sg:nom:m1
grand	granda	subst:pl:gen:f
grenady	-	-
groznego	-	-
grudnia	grudzień	subst:sg:gen:m3
grupy	grupa	subst:pl:acc:f+subst:pl:nom:f+subst:pl:voc:f+subst:sg:gen:f
gruzji	-	-
gwałtownych	gwałtowny	adj:pl:acc:m1.p1:pos+adj:pl:gen:m1.m2.m3.f.n1.n2.p1.p2.p3:pos+adj:pl:loc:m1.m2.m3.f.n1.n2.p1.p2.p3:pos
górnej	górny	adj:sg:dat:f:pos+adj:sg:gen:f:pos+adj:sg:loc:f:pos
głosowania	głosowanie	subst:pl:acc:n2+subst:pl:nom:n2+subst:pl:voc:n2+subst:sg:gen:n2
głosowania	głosować	ger:sg:gen:n2:imperf:aff:nonrefl
głowy	głowa	subst:pl:acc:f+subst:pl:nom:f+subst:pl:voc:f+subst:sg:gen:f
głównych	główny	adj:pl:acc:m1.p1:pos+adj:pl:gen:m1.m2.m3.f.n1.n2.p1.p2.p3:pos+adj:pl:loc:m1.m2.m3.f.n1.n2.p1.p2.p3:pos
głębokiej	głęboki	adj:sg:dat:f:pos+adj:sg:gen:f:pos+adj:sg:loc:f:pos
helikoptera	helikopter	subst:sg:gen:m3
hiszpanii	-	-
hollywood	-	-
hurtowników	hurtownik	subst:pl:acc:m1+subst:pl:gen:m1
i	i	conj+interj+qub
ich	on	ppron3:pl:acc:m1.p1:ter:akc.nakc:npraep+ppron3:pl:gen:m1.m2.m3.f.n1.n2.p1.p2.p3:ter:akc.nakc:npraep
ideologii	ideologia	subst:pl:gen:f+subst:sg:dat:f+subst:sg:gen:f+subst:sg:loc:f
igrzysk	igrzyska	subst:pl:gen:p3
igrzysk	igrzysko	subst:pl:gen:n2
ii	ii	interj
iii	iii	interj
imprezy	impreza	subst:pl:acc:f
imprezy	impreza	subst:pl:nom:f
imprezy	impreza	subst:pl:voc:f
imprezy	impreza	subst:sg:gen:f
incydentu	incydent	subst:sg:gen:m3
indii	-	-
inguszetii	-	-
inicjatywy	inicjatywa	subst:pl:acc:f+subst:pl:nom:f+subst:pl:voc:f+subst:sg:gen:f
innego	inny	adj:sg:acc:m1.m2:pos+adj:sg:gen:m1.m2.m3.n1.n2:pos+subst:sg:acc:m1+subst:sg:gen:m1
innych	inny	adj:pl:acc:m1.p1:pos+adj:pl:gen:m1.m2.m3.f.n1.n2.p1.p2.p3:pos+adj:pl:loc:m1.m2.m3.f.n1.n2.p1.p2.p3:pos+subst:pl:acc:m1+subst:pl:gen:m1+subst:pl:loc:m1
instytucji	instytucja	subst:pl:gen:f+subst:sg:dat:f+subst:sg:gen:f+subst:sg:loc:f
integracji	integracja	subst:pl:gen:f+subst:sg:dat:f+subst:sg:gen:f+subst:sg:loc:f
internetu	internet	subst:sg:gen:m3
interwencji	interwencja	subst:pl:gen:f+subst:sg:dat:f+subst:sg:gen:f+subst:sg:loc:f
inwestora	inwestor	subst:sg:acc:m1+subst:sg:gen:m1
inwestowania	inwestować	ger:sg:gen:n2:imperf:aff:refl.nonrefl
ipn	-	-
iraku	-	-
ise	-	-
iserni	-	-
istotnych	istotny	adj:pl:acc:m1.p1:pos+adj:pl:gen:m1.m2.m3.f.n1.n2.p1.p2.p3:pos+adj:pl:loc:m1.m2.m3.f.n1.n2.p1.p2.p3:pos
izraela	-	-
jacka	jack	subst:sg:gen:m3
jadlospisu	-	-
jaen	-	-
jakich	jaki	adj:pl:acc:m1.p1:pos+adj:pl:gen:m1.m2.m3.f.n1.n2.p1.p2.p3:pos+adj:pl:loc:m1.m2.m3.f.n1.n2.p1.p2.p3:pos
jakiego	jaki	adj:sg:acc:m1.m2:pos+adj:sg:gen:m1.m2.m3.n1.n2:pos
japonskiego	-	-
jedenastu	jedenaście	num:pl:acc:m1:rec+num:pl:gen.dat.inst.loc:m1.m2.m3.f.n2:congr+num:pl:nom.voc:m1:rec
jednego	jedno	subst:sg:gen:n2
jednego	jeden	adj:sg:acc:m1.m2:pos+adj:sg:gen:m1.m2.m3.n1.n2:pos+subst:sg:acc:m2+subst:sg:gen:m2
jednej	jeden	adj:sg:dat:f:pos+adj:sg:gen:f:pos+adj:sg:loc:f:pos
jedności	jedności	subst:pl:acc:p3+subst:pl:gen:p3+subst:pl:nom:p3+subst:pl:voc:p3
jedności	jedność	subst:pl:acc:f+subst:pl:gen:f+subst:pl:nom:f+subst:pl:voc:f+subst:sg:dat:f+subst:sg:gen:f+subst:sg:loc:f+subst:sg:voc:f
jego	on	ppron3:sg:acc:m1.m2.m3:ter:akc:npraep+ppron3:sg:gen:m1.m2.m3:ter:akc:npraep+ppron3:sg:gen:n1.n2:ter:akc:npraep
jerozolimy	-	-
jerzego	-	-
józefa	-	-
kanady	kanada	subst:pl:acc:f
kanady	kanada	subst:pl:nom:f
kanady	kanada	subst:pl:voc:f
kanady	kanada	subst:sg:gen:f
kaplanstwa	-	-
karnawału	karnawał	subst:sg:gen:m3
kasety	kaseta	subst:pl:acc:f+subst:pl:nom:f+subst:pl:voc:f+subst:sg:gen:f
kasy	kasa	subst:pl:acc:f+subst:pl:nom:f+subst:pl:voc:f+subst:sg:gen:f
kazachstanu	-	-
każdej	każdy	adj:sg:dat:f:pos+adj:sg:gen:f:pos+adj:sg:loc:f:pos
kijowa	kijowy	adj:sg:nom.voc:f:pos
kilku	kilka	num:comp+num:pl:acc:m1:rec+num:pl:gen.dat.inst.loc:m1.m2.m3.f.n2:congr+num:pl:nom.voc:m1:rec
kilkuset	kilkaset	num:comp+num:pl:acc:m1:rec+num:pl:gen.dat.inst.loc:m1.m2.m3.f.n1.n2.p1.p2:congr+num:pl:nom.voc:m1:rec
klasyfikacji	klasyfikacja	subst:pl:gen:f+subst:sg:dat:f+subst:sg:gen:f+subst:sg:loc:f
klasztoru	klasztor	subst:sg:gen:m3
klęski	klęska	subst:pl:acc:f+subst:pl:nom:f+subst:pl:voc:f+subst:sg:gen:f
koalicyjnego	koalicyjny	adj:sg:acc:m1.m2:pos+adj:sg:gen:m1.m2.m3.n1.n2:pos
koethen	-	-
kolan	kolanin	subst:pl:acc:m1+subst:pl:gen:m1
kolan	kolano	subst:pl:gen:n2
kolegium	kolegium	subst:sg:acc:n2+subst:sg:dat:n2+subst:sg:gen:n2+subst:sg:inst:n2+subst:sg:loc:n2+subst:sg:nom:n2+subst:sg:voc:n2
kolegów	kolega	subst:pl:acc:m1+subst:pl:gen:m1
kolei	kolej	subst:pl:gen:f+subst:sg:dat:f+subst:sg:gen:f+subst:sg:loc:f+subst:sg:voc:f
kolei	koleja	subst:pl:gen:f+subst:sg:dat:f+subst:sg:gen:f+subst:sg:loc:f
kolejnego	kolejny	adj:sg:acc:m1.m2:pos+adj:sg:gen:m1.m2.m3.n1.n2:pos
kolejnych	kolejny	adj:pl:acc:m1.p1:pos+adj:pl:gen:m1.m2.m3.f.n1.n2.p1.p2.p3:pos+adj:pl:loc:m1.m2.m3.f.n1.n2.p1.p2.p3:pos
kombinacji	kombinacja	subst:pl:gen:f+subst:sg:dat:f+subst:sg:gen:f+subst:sg:loc:f
komisji	komisja	subst:pl:gen:f+subst:sg:dat:f+subst:sg:gen:f+subst:sg:loc:f
komory	komora	subst:pl:acc:f+subst:pl:nom:f+subst:pl:voc:f+subst:sg:gen:f
komputerow	-	-
konca	-	-
konfliktu	konflikt	subst:sg:gen:m3
konga	konga	subst:sg:nom:f
konkretnych	konkretny	adj:pl:acc:m1.p1:pos+adj:pl:gen:m1.m2.m3.f.n1.n2.p1.p2.p3:pos+adj:pl:loc:m1.m2.m3.f.n1.n2.p1.p2.p3:pos
konkursu	konkurs	subst:sg:gen:m3
konsekwentnego	konsekwentny	adj:sg:acc:m1.m2:pos+adj:sg:gen:m1.m2.m3.n1.n2:pos
konstruktywnej	konstruktywny	adj:sg:dat:f:pos+adj:sg:gen:f:pos+adj:sg:loc:f:pos
kontroli	kontrola	subst:pl:gen:f+subst:sg:dat:f+subst:sg:gen:f+subst:sg:loc:f
kontrolowanej	kontrolowany	adj:sg:dat:f:pos+adj:sg:gen:f:pos+adj:sg:loc:f:pos
kontrolowanej	kontrolować	ppas:sg:gen.dat.loc:f:imperf:aff
kopalń	kopalnia	subst:pl:gen:f
kosowa	-	-
kostek	kostka	subst:pl:gen:f
kostek	kostki	subst:pl:gen:p3
kosza	kosz	subst:sg:acc:m2
kosza	kosz	subst:sg:gen:m2+subst:sg:gen:m3
końca	koniec	subst:sg:gen:m3
krajow	-	-
krajowego	krajowy	adj:sg:acc:m1.m2:pos+adj:sg:gen:m1.m2.m3.n1.n2:pos
krajowej	krajowy	adj:sg:dat:f:pos+adj:sg:gen:f:pos+adj:sg:loc:f:pos
kraju	kraj	subst:sg:gen:m3
kraju	kraj	subst:sg:loc:m3
kraju	kraj	subst:sg:voc:m3
krajów	kraj	subst:pl:gen:m3
krakowa	-	-
krakowskiego	krakowski	adj:sg:acc:m1.m2:pos+adj:sg:gen:m1.m2.m3.n1.n2:pos
kruszenia	kruszenie	subst:pl:acc:n2+subst:pl:nom:n2+subst:pl:voc:n2+subst:sg:gen:n2
kruszenia	kruszeć	ger:sg:gen:n2:imperf:aff:nonrefl
kruszenia	kruszeń	subst:sg:gen:m3
kruszenia	kruszyć	ger:sg:gen:n2:imperf:aff:refl.nonrefl
krytycznej	krytyczny	adj:sg:dat:f:pos+adj:sg:gen:f:pos+adj:sg:loc:f:pos
krzaklewskiego	-	-
krótkowzroczności	krótkowzroczność	subst:pl:acc:f+subst:pl:gen:f+subst:pl:nom:f+subst:pl:voc:f+subst:sg:dat:f+subst:sg:gen:f+subst:sg:loc:f+subst:sg:voc:f
księgi	księgi	subst:pl:acc:p3+subst:pl:nom:p3+subst:pl:voc:p3
księgi	księga	subst:pl:acc:f+subst:pl:nom:f+subst:pl:voc:f+subst:sg:gen:f
ktorej	-	-
którego	który	adj:sg:acc:m1.m2:pos+adj:sg:gen:m1.m2.m3.n1.n2:pos
której	który	adj:sg:dat:f:pos+adj:sg:gen:f:pos+adj:sg:loc:f:pos
których	który	adj:pl:acc:m1.p1:pos+adj:pl:gen:m1.m2.m3.f.n1.n2.p1.p2.p3:pos+adj:pl:loc:m1.m2.m3.f.n1.n2.p1.p2.p3:pos
kupienia	kupić	ger:sg:gen:n2:perf:aff:refl.nonrefl
kupowania	kupować	ger:sg:gen:n2:imperf:aff:refl.nonrefl
kwietnia	kwietni	adj:sg:nom.voc:f:pos
kwietnia	kwiecień	subst:sg:gen:m3
laski	laski	adj:sg:acc:m3:pos+adj:sg:nom.voc:m1.m2.m3:pos
laski	laska	subst:pl:acc:f+subst:pl:nom:f+subst:pl:voc:f+subst:sg:gen:f
laski	lasek	subst:pl:acc:m3
laski	lasek	subst:pl:nom:m3
laski	lasek	subst:pl:voc:m3
lasu	las	subst:sg:gen:m3
lat	lato	subst:pl:gen:n2
lat	rok	subst:pl:gen:m3
laureatów	laureat	subst:pl:acc:m1+subst:pl:gen:m1
lecha	lecha	subst:sg:nom:f
leicester	-	-
lekarza	lekarz	subst:sg:acc:m1+subst:sg:gen:m1
lekarzy	lekarz	subst:pl:acc:m1+subst:pl:gen:m1
lepszej	dobry	adj:sg:dat:f:com+adj:sg:gen:f:com+adj:sg:loc:f:com
leszka	-	-
lewego	lewy	adj:sg:acc:m1.m2:pos+adj:sg:gen:m1.m2.m3.n1.n2:pos+subst:sg:gen:m3
lidera	lider	subst:sg:acc:m1+subst:sg:gen:m1
liderów	lider	subst:pl:acc:m1+subst:pl:gen:m1
linii	linia	subst:pl:gen:f+subst:sg:dat:f+subst:sg:gen:f+subst:sg:loc:f
listopada	listopad	subst:sg:gen:m3
listu	list	subst:sg:gen:m3
lokalu	lokal	subst:sg:gen:m3+subst:sg:loc:m3+subst:sg:voc:m3
lorki	lorka	subst:pl:acc:f+subst:pl:nom:f+subst:pl:voc:f+subst:sg:gen:f
los	los	subst:sg:acc:m3+subst:sg:nom:m3
loule	-	-
ludzi	ludzie	subst:pl:acc:p1+subst:pl:gen:p1
ludzi	człowiek	subst:pl:acc:m1+subst:pl:gen:m1
lustracji	lustracja	subst:pl:gen:f+subst:sg:dat:f+subst:sg:gen:f+subst:sg:loc:f
lutego	luty	adj:sg:acc:m1.m2:pos+adj:sg:gen:m1.m2.m3.n1.n2:pos+subst:sg:gen:m3
macieja	-	-
madeleine	-	-
maksymalizacji	maksymalizacja	subst:pl:gen:f+subst:sg:dat:f+subst:sg:gen:f+subst:sg:loc:f
manifestacji	manifestacja	subst:pl:gen:f+subst:sg:dat:f+subst:sg:gen:f+subst:sg:loc:f
marca	marzec	subst:sg:gen:m3
marcowych	marcowy	adj:pl:acc:m1.p1:pos+adj:pl:gen:m1.m2.m3.f.n1.n2.p1.p2.p3:pos+adj:pl:loc:m1.m2.m3.f.n1.n2.p1.p2.p3:pos
marka	marka	subst:sg:nom:f
marka	marek	subst:sg:acc:m1
marka	marek	subst:sg:acc:m2+subst:sg:gen:m1
marka	marek	subst:sg:gen:m2+subst:sg:gen:m3
marki	marka	subst:pl:acc:f+subst:pl:nom:f+subst:pl:voc:f+subst:sg:gen:f
marki	marek	depr:pl:nom:m2
marki	marek	depr:pl:voc:m2
marki	marek	subst:pl:acc:m2+subst:pl:acc:m3+subst:pl:nom:m2+subst:pl:nom:m3+subst:pl:voc:m2+subst:pl:voc:m3
marszalka	-	-
marszałka	marszałek	subst:sg:acc:m1
marszałka	marszałek	subst:sg:gen:m1
mediów	media	subst:pl:gen:p3
mediów	medium	subst:pl:gen:n2
mety	meta	subst:pl:acc:f+subst:pl:nom:f+subst:pl:voc:f+subst:sg:gen:f
miami	-	-
miana	miana	subst:sg:nom:f
miana	miano	subst:pl:acc:n2+subst:pl:nom:n2+subst:pl:voc:n2+subst:sg:gen:n2
miana	mieć	ppas:sg:nom.voc:f:imperf:aff
miasta	miasto	subst:pl:acc:n2+subst:pl:nom:n2+subst:pl:voc:n2+subst:sg:gen:n2
miejsc	miejsce	subst:pl:gen:n2
miejscowości	miejscowość	subst:pl:acc:f+subst:pl:gen:f+subst:pl:nom:f+subst:pl:voc:f+subst:sg:dat:f+subst:sg:gen:f+subst:sg:loc:f+subst:sg:voc:f
miejscowych	miejscowy	adj:pl:acc:m1.p1:pos+adj:pl:gen:m1.m2.m3.f.n1.n2.p1.p2.p3:pos+adj:pl:loc:m1.m2.m3.f.n1.n2.p1.p2.p3:pos+subst:pl:acc:m1+subst:pl:gen:m1+subst:pl:loc:m1
miejscowych	miejscowa	subst:pl:gen:f+subst:pl:loc:f
miejscowych	miejscowe	subst:pl:gen:n2+subst:pl:loc:n2
mieszkania	mieszkanie	subst:pl:acc:n2+subst:pl:nom:n2+subst:pl:voc:n2+subst:sg:gen:n2
mieszkania	mieszkać	ger:sg:gen:n2:imperf:aff:nonrefl
minimum	minimum	qub+subst:sg:acc:n2+subst:sg:dat:n2+subst:sg:gen:n2+subst:sg:inst:n2+subst:sg:loc:n2+subst:sg:nom:n2+subst:sg:voc:n2
ministerstwa	ministerstwo	subst:pl:acc:n2+subst:pl:nom:n2+subst:pl:voc:n2+subst:sg:gen:n2
ministra	minister	subst:sg:acc:m1+subst:sg:gen:m1
mistrzostw	mistrzostwa	subst:pl:gen:p3
mistrzostw	mistrzostwo	subst:pl:gen:n2
mnie	miąć	verb:fin:sg:ter:imperf:refl.nonrefl
mnie	ja	ppron12:sg:acc:m1.m2.m3.f.n1.n2:pri:akc+ppron12:sg:dat:m1.m2.m3.f.n1.n2:pri:akc+ppron12:sg:gen:m1.m2.m3.f.n1.n2:pri:akc+ppron12:sg:loc:m1.m2.m3.f.n1.n2:pri
modernizacji	modernizacja	subst:pl:gen:f+subst:sg:dat:f+subst:sg:gen:f+subst:sg:loc:f
monte	-	-
morawskiej	morawski	adj:sg:dat:f:pos+adj:sg:gen:f:pos+adj:sg:loc:f:pos
moskwy	-	-
mostostalu	-	-
mostu	most	subst:sg:gen:m3
mołdawii	-	-
mswia	-	-
msz	-	-
młodych	młody	adj:pl:acc:m1.p1:pos+adj:pl:gen:m1.m2.m3.f.n1.n2.p1.p2.p3:pos+adj:pl:loc:m1.m2.m3.f.n1.n2.p1.p2.p3:pos+subst:pl:acc:m1+subst:pl:gen:m1+subst:pl:loc:m1
młodych	młoda	subst:pl:gen:f+subst:pl:loc:f
młodych	młode	subst:pl:gen:n2+subst:pl:loc:n2
nagiego	nagi	adj:sg:acc:m1.m2:pos+adj:sg:gen:m1.m2.m3.n1.n2:pos+subst:sg:acc:m1+subst:sg:gen:m1
nagrody	nagroda	subst:pl:acc:f+subst:pl:nom:f+subst:pl:voc:f+subst:sg:gen:f
najbardziej	najbardziej	adv
najbliższego	bliski	adj:sg:acc:m1.m2:sup+adj:sg:gen:m1.m2.m3.n1.n2:sup
najpilniejszych	pilny	adj:pl:acc:m1.p1:sup+adj:pl:gen:m1.m2.m3.f.n1.n2.p1.p2.p3:sup+adj:pl:loc:m1.m2.m3.f.n1.n2.p1.p2.p3:sup
naprawy	naprawa	subst:pl:acc:f
naprawy	naprawa	subst:pl:nom:f
naprawy	naprawa	subst:pl:voc:f
naprawy	naprawa	subst:sg:gen:f
naruszenia	naruszenie	subst:pl:acc:n2+subst:pl:nom:n2+subst:pl:voc:n2+subst:sg:gen:n2
naruszenia	naruszyć	ger:sg:gen:n2:perf:aff:refl.nonrefl
nas	my	ppron12:pl:acc:m1.m2.m3.f.n1.n2.p1.p2.p3:pri+ppron12:pl:gen:m1.m2.m3.f.n1.n2.p1.p2.p3:pri+ppron12:pl:loc:m1.m2.m3.f.n1.n2.p1.p2.p3:pri
następnego	następny	adj:sg:acc:m1.m2:pos+adj:sg:gen:m1.m2.m3.n1.n2:pos+subst:sg:acc:m1+subst:sg:gen:m1
naszych	nasz	adj:pl:acc:m1.p1:pos+adj:pl:gen:m1.m2.m3.f.n1.n2.p1.p2.p3:pos+adj:pl:loc:m1.m2.m3.f.n1.n2.p1.p2.p3:pos
naszych	nasze	subst:pl:gen:n2+subst:pl:loc:n2
naszych	nasi	subst:pl:acc:p1+subst:pl:gen:p1+subst:pl:loc:p1
nato	-	-
natychmiastowego	natychmiastowy	adj:sg:acc:m1.m2:pos+adj:sg:gen:m1.m2.m3.n1.n2:pos
nazizmu	nazizm	subst:sg:gen:m3
negocjacji	negocjacja	subst:pl:gen:f+subst:sg:dat:f+subst:sg:gen:f+subst:sg:loc:f
negocjacji	negocjacje	subst:pl:gen:p3
negocjatorów	negocjator	subst:pl:acc:m1+subst:pl:gen:m1
nepotyzmu	nepotyzm	subst:sg:gen:m3
nich	on	ppron3:pl:acc:m1.p1:ter:akc.nakc:praep+ppron3:pl:gen:m1.m2.m3.f.n1.n2.p1.p2.p3:ter:akc.nakc:praep+ppron3:pl:loc:m1.m2.m3.f.n1.n2.p1.p2.p3:ter:akc.nakc:praep.npraep
niebieskich	niebieski	adj:pl:acc:m1.p1:pos+adj:pl:gen:m1.m2.m3.f.n1.n2.p1.p2.p3:pos+adj:pl:loc:m1.m2.m3.f.n1.n2.p1.p2.p3:pos
niedzieli	niedziela	subst:pl:gen:f+subst:sg:dat:f+subst:sg:gen:f+subst:sg:loc:f
niego	on	ppron3:sg:acc:m1.m2.m3:ter:akc:praep+ppron3:sg:gen:m1.m2.m3:ter:akc:praep+ppron3:sg:gen:n1.n2:ter:akc.nakc:praep
niej	on	ppron3:sg:dat:f:ter:akc.nakc:praep+ppron3:sg:gen:f:ter:akc.nakc:praep+ppron3:sg:loc:f:ter:akc.nakc:praep.npraep
niektórych	niektóry	adj:pl:acc:m1.p1:pos+adj:pl:gen:m1.m2.m3.f.n1.n2.p1.p2.p3:pos+adj:pl:loc:m1.m2.m3.f.n1.n2.p1.p2.p3:pos+subst:pl:acc:m1+subst:pl:gen:m1+subst:pl:loc:m1
niemiec	niemiec	subst:sg:nom:m1
niemiec	niemiec	subst:sg:nom:m2
nienawisci	-	-
nieoczekiwanego	nieoczekiwany	adj:sg:acc:m1.m2:pos+adj:sg:gen:m1.m2.m3.n1.n2:pos
nieoczekiwanego	oczekiwać	ppas:sg:acc:m1.m2:imperf:neg+ppas:sg:gen:m1.m2.m3.n1.n2:imperf:neg
nieodwracalnych	nieodwracalny	adj:pl:acc:m1.p1:pos+adj:pl:gen:m1.m2.m3.f.n1.n2.p1.p2.p3:pos+adj:pl:loc:m1.m2.m3.f.n1.n2.p1.p2.p3:pos
niestosowania	stosować	ger:sg:gen:n2:imperf:neg:refl.nonrefl
nieudzielania	udzielać	ger:sg:gen:n2:imperf:neg:refl.nonrefl
nieujawniania	ujawniać	ger:sg:gen:n2:imperf:neg:refl.nonrefl
niewielkiej	niewielki	adj:sg:dat:f:pos+adj:sg:gen:f:pos+adj:sg:loc:f:pos
niezwykle	niezwykle	adv:pos
nike	nike	subst:pl:acc:f
nike	nike	subst:pl:dat:f
nike	nike	subst:pl:gen:f
nike	nike	subst:pl:inst:f
nike	nike	subst:pl:loc:f
nike	nike	subst:pl:nom:f
nike	nike	subst:pl:voc:f
nike	nike	subst:sg:acc:f
nike	nike	subst:sg:dat:f
nike	nike	subst:sg:gen:f
nike	nike	subst:sg:inst:f
nike	nike	subst:sg:loc:f
nike	nike	subst:sg:nom:f
nike	nike	subst:sg:voc:f
nome	-	-
norm	norma	subst:pl:gen:f
norwegii	-	-
norweskiego	norweski	adj:sg:acc:m1.m2:pos+adj:sg:gen:m1.m2.m3.n1.n2:pos+subst:sg:gen:m3
nowego	nowe	subst:sg:gen:n2
nowego	nowy	adj:sg:acc:m1.m2:pos+adj:sg:gen:m1.m2.m3.n1.n2:pos+subst:sg:acc:m1+subst:sg:gen:m1
nowej	nowa	subst:sg:dat:f+subst:sg:gen:f+subst:sg:loc:f
nowej	nowy	adj:sg:dat:f:pos+adj:sg:gen:f:pos+adj:sg:loc:f:pos
nowelizacji	nowelizacja	subst:pl:gen:f+subst:sg:dat:f+subst:sg:gen:f+subst:sg:loc:f
nowo	nowo	adv:pos
nowych	nowy	adj:pl:acc:m1.p1:pos+adj:pl:gen:m1.m2.m3.f.n1.n2.p1.p2.p3:pos+adj:pl:loc:m1.m2.m3.f.n1.n2.p1.p2.p3:pos+subst:pl:acc:m1+subst:pl:gen:m1+subst:pl:loc:m1
nowych	nowa	subst:pl:gen:f+subst:pl:loc:f
nowych	nowe	subst:pl:gen:n2
nowych	nowe	subst:pl:loc:n2
nożaj	-	-
nsa	-	-
obalenia	obalenie	subst:pl:acc:n2+subst:pl:nom:n2+subst:pl:voc:n2+subst:sg:gen:n2
obalenia	obalić	ger:sg:gen:n2:perf:aff:refl.nonrefl
obniżki	obniżka	subst:pl:acc:f+subst:pl:nom:f+subst:pl:voc:f+subst:sg:gen:f
obowiązkowej	obowiązkowy	adj:sg:dat:f:pos+adj:sg:gen:f:pos+adj:sg:loc:f:pos
obozu	obóz	subst:sg:gen:m3
obozów	obóz	subst:pl:gen:m3
obrony	obrona	subst:pl:acc:f+subst:pl:nom:f+subst:pl:voc:f+subst:sg:gen:f
obrotu	obrót	subst:sg:gen:m3
obszaru	obszar	subst:sg:gen:m3
obsługi	obsługa	subst:pl:acc:f+subst:pl:nom:f+subst:pl:voc:f+subst:sg:gen:f
ochrony	ochrona	subst:pl:acc:f+subst:pl:nom:f+subst:pl:voc:f+subst:sg:gen:f
oczekujących	oczekujący	adj:pl:acc:m1.p1:pos+adj:pl:gen:m1.m2.m3.f.n1.n2.p1.p2.p3:pos+adj:pl:loc:m1.m2.m3.f.n1.n2.p1.p2.p3:pos
oczekujących	oczekiwać	pact:pl:acc:m1.p1:imperf:aff:refl.nonrefl+pact:pl:gen.loc:m1.m2.m3.f.n1.n2.p1.p2.p3:imperf:aff:refl.nonrefl
odczytania	odczytać	ger:sg:gen:n2:perf:aff:refl.nonrefl
oddalonego	oddalony	adj:sg:acc:m1.m2:pos+adj:sg:gen:m1.m2.m3.n1.n2:pos
oddalonego	oddalić	ppas:sg:acc:m1.m2:perf:aff+ppas:sg:gen:m1.m2.m3.n1.n2:perf:aff
odry	odra	subst:pl:acc:f
odry	odra	subst:pl:nom:f
odry	odra	subst:pl:voc:f
odry	odra	subst:sg:gen:f
odrzucenia	odrzucenie	subst:pl:acc:n2+subst:pl:nom:n2+subst:pl:voc:n2+subst:sg:gen:n2
odrzucenia	odrzucić	ger:sg:gen:n2:perf:aff:refl.nonrefl
odwiedzenia	odwiedzenie	subst:pl:acc:n2+subst:pl:nom:n2+subst:pl:voc:n2+subst:sg:gen:n2
odwiedzenia	odwiedzić	ger:sg:gen:n2:perf:aff:refl.nonrefl
odwiedzenia	odwieść	ger:sg:gen:n2:perf:aff:refl.nonrefl
odwolania	-	-
odwołania	odwołanie	subst:pl:acc:n2+subst:pl:nom:n2+subst:pl:voc:n2+subst:sg:gen:n2
odwołania	odwołać	ger:sg:gen:n2:perf:aff:refl.nonrefl
ofe	-	-
ofiar	ofiara	subst:pl:gen:f
ogólnego	ogólny	adj:sg:acc:m1.m2:pos+adj:sg:gen:m1.m2.m3.n1.n2:pos
ojca	ojciec	subst:sg:acc:m1+subst:sg:gen:m1
ojczyzny	ojczyzna	subst:pl:acc:f+subst:pl:nom:f+subst:pl:voc:f+subst:sg:gen:f
ok	oko	subst:pl:gen:n2
ok	około	brev:pun
około	około	adv:pos+prep:gen+qub
olimpiady	olimpiada	subst:pl:acc:f+subst:pl:nom:f+subst:pl:voc:f+subst:sg:gen:f
onz	-	-
operacji	operacja	subst:pl:gen:f+subst:sg:dat:f+subst:sg:gen:f+subst:sg:loc:f
opinii	opinia	subst:pl:gen:f+subst:sg:dat:f+subst:sg:gen:f+subst:sg:loc:f
opuszczania	opuszczać	ger:sg:gen:n2:imperf:aff:refl.nonrefl
orawic	-	-
organizacji	organizacja	subst:pl:gen:f+subst:sg:dat:f+subst:sg:gen:f+subst:sg:loc:f
orzekania	orzekać	ger:sg:gen:n2:imperf:aff:refl.nonrefl
oscara	oscar	subst:sg:acc:m2
oscara	oscar	subst:sg:gen:m2
oscarów	oscar	subst:pl:gen:m2
oskara	-	-
ostatniego	ostatnie	subst:sg:gen:n2
ostatniego	ostatni	adj:sg:acc:m1.m2:pos+adj:sg:gen:m1.m2.m3.n1.n2:pos+subst:sg:acc:m1+subst:sg:gen:m1
ostatniej	ostatni	adj:sg:dat:f:pos+adj:sg:gen:f:pos+adj:sg:loc:f:pos
ostrego	ostry	adj:sg:acc:m1.m2:pos+adj:sg:gen:m1.m2.m3.n1.n2:pos
otwarcia	otwarcie	subst:pl:acc:n2+subst:pl:nom:n2+subst:pl:voc:n2+subst:sg:gen:n2
otwarcia	otworzyć	ger:sg:gen:n2:perf:aff:refl.nonrefl
paktu	pakt	subst:sg:gen:m3
palacu	-	-
pana	pan	subst:sg:acc:m1
pana	pan	subst:sg:gen:m1
pap	papa	subst:pl:gen:f
parany	-	-
parlamentarzystów	parlamentarzysta	subst:pl:acc:m1+subst:pl:gen:m1
parlamentu	parlament	subst:sg:gen:m3
partii	partia	subst:pl:gen:f
partii	partia	subst:sg:dat:f
partii	partia	subst:sg:gen:f
partii	partia	subst:sg:loc:f
pasatów	pasat	subst:pl:gen:m3
państwa	państwo	subst:pl:acc:n2+subst:pl:acc:p1+subst:pl:gen:p1+subst:pl:nom:n2+subst:pl:voc:n2+subst:sg:gen:n2
październikalistopada	-	-
pekinu	pekin	subst:sg:gen:m3
petersburga	-	-
pettingu	petting	subst:sg:gen:m3+subst:sg:loc:m3+subst:sg:voc:m3
pełni	pełnia	subst:pl:gen:f+subst:sg:dat:f+subst:sg:gen:f+subst:sg:loc:f
pełni	pełnić	verb:fin:sg:ter:imperf:refl.nonrefl
pełni	pełny	adj:pl:nom.voc:m1.p1:pos
piatku	-	-
pieciu	-	-
pierwszego	pierwsze	subst:sg:gen:n2
pierwszego	pierwszy	adj:sg:acc:m1.m2:pos+adj:sg:gen:m1.m2.m3.n1.n2:pos+subst:sg:gen:m3
pierwszej	pierwsza	subst:sg:dat:f+subst:sg:gen:f+subst:sg:loc:f
pierwszej	pierwszy	adj:sg:dat:f:pos+adj:sg:gen:f:pos+adj:sg:loc:f:pos
pilnowania	pilnować	ger:sg:gen:n2:imperf:aff:refl.nonrefl
pisania	pisanie	subst:pl:acc:n2+subst:pl:nom:n2+subst:pl:voc:n2+subst:sg:gen:n2
pisania	pisać	ger:sg:gen:n2:imperf:aff:refl.nonrefl
piątej	piąta	subst:sg:dat:f+subst:sg:gen:f+subst:sg:loc:f
piątej	piąty	adj:sg:dat:f:pos+adj:sg:gen:f:pos+adj:sg:loc:f:pos
piątkowego	piątkowy	adj:sg:acc:m1.m2:pos+adj:sg:gen:m1.m2.m3.n1.n2:pos
pięciu	pięć	num:pl:acc:m1:rec+num:pl:gen.dat.inst.loc:m1.m2.m3.f.n2:congr+num:pl:nom.voc:m1:rec
pięciu	piąć	ger:sg:dat.loc:n2:imperf:aff:refl
pkt	punkt	brev:npun
play	-	-
pociągu	pociąg	subst:sg:gen:m3+subst:sg:loc:m3+subst:sg:voc:m3
poczatku	-	-
poczty	poczt	subst:pl:acc:m3+subst:pl:nom:m3+subst:pl:voc:m3
poczty	poczta	subst:pl:acc:f+subst:pl:nom:f+subst:pl:voc:f+subst:sg:gen:f
poczty	poczet	subst:pl:acc:m3+subst:pl:nom:m3+subst:pl:voc:m3
początku	początek	subst:sg:gen:m3
początku	początek	subst:sg:loc:m3
początku	początek	subst:sg:voc:m3
podejmowania	podejmować	ger:sg:gen:n2:imperf:aff:refl.nonrefl
podjęcia	podjęcie	subst:pl:acc:n2+subst:pl:nom:n2+subst:pl:voc:n2+subst:sg:gen:n2
podjęcia	podjąć	ger:sg:gen:n2:perf:aff:refl.nonrefl
podlozenia	-	-
podobnych	podobny	adj:pl:acc:m1.p1:pos+adj:pl:gen:m1.m2.m3.f.n1.n2.p1.p2.p3:pos+adj:pl:loc:m1.m2.m3.f.n1.n2.p1.p2.p3:pos
podziemia	podziemie	subst:pl:acc:n2+subst:pl:nom:n2+subst:pl:voc:n2+subst:sg:gen:n2
poglosek	-	-
pogodzenia	pogodzić	ger:sg:gen:n2:perf:aff:nonrefl+ger:sg:gen:n2:perf:aff:refl.nonrefl
pokoju	pokój	subst:sg:gen:m3+subst:sg:loc:m3+subst:sg:voc:m3
pokonania	pokonanie	subst:pl:acc:n2+subst:pl:nom:n2+subst:pl:voc:n2+subst:sg:gen:n2
pokonania	pokonać	ger:sg:gen:n2:perf:aff:refl.nonrefl
polfinalow	-	-
polfinalu	-	-
polityki	polityk	depr:pl:nom:m2+depr:pl:voc:m2
polityki	polityka	subst:pl:acc:f+subst:pl:nom:f+subst:pl:voc:f+subst:sg:gen:f
polnocnej	-	-
polski	polski	adj:sg:acc:m3:pos+adj:sg:nom.voc:m1.m2.m3:pos+subst:sg:acc:m3
polski	polski	subst:sg:nom:m3
polski	polski	subst:sg:voc:m3
polskiego	polskie	subst:sg:gen:n2
polskiego	polski	adj:sg:acc:m1.m2:pos+adj:sg:gen:m1.m2.m3.n1.n2:pos
polskiego	polski	subst:sg:gen:m3
polskiej	polski	adj:sg:dat:f:pos+adj:sg:gen:f:pos+adj:sg:loc:f:pos
pomocy	pomoc	subst:pl:gen:f+subst:sg:dat:f+subst:sg:gen:f+subst:sg:loc:f+subst:sg:voc:f
pomysłu	pomysł	subst:sg:gen:m3
ponad	ponad	prep:acc:nwok+prep:inst:nwok+qub
poniedziałku	poniedziałek	subst:sg:gen:m3
poniedziałku	poniedziałek	subst:sg:loc:m3
poniedziałku	poniedziałek	subst:sg:voc:m3
popierania	popierać	ger:sg:gen:n2:imperf:aff:refl.nonrefl
popołudnia	popołudnie	subst:pl:acc:n2+subst:pl:nom:n2+subst:pl:voc:n2+subst:sg:gen:n2
poprawienia	poprawić	ger:sg:gen:n2:perf:aff:refl.nonrefl
poprawy	poprawa	subst:pl:acc:f+subst:pl:nom:f+subst:pl:voc:f+subst:sg:gen:f
poprzedniego	poprzedni	adj:sg:acc:m1.m2:pos+adj:sg:gen:m1.m2.m3.n1.n2:pos
porozumienia	porozumienie	subst:pl:acc:n2+subst:pl:nom:n2+subst:pl:voc:n2+subst:sg:gen:n2
porozumienia	porozumieć	ger:sg:gen:n2:perf:aff:refl
porządku	porządek	subst:sg:gen:m3+subst:sg:loc:m3+subst:sg:voc:m3
poszczególnych	poszczególny	adj:pl:acc:m1.p1:pos+adj:pl:gen:m1.m2.m3.f.n1.n2.p1.p2.p3:pos+adj:pl:loc:m1.m2.m3.f.n1.n2.p1.p2.p3:pos
poszerzenia	poszerzenie	subst:pl:acc:n2+subst:pl:nom:n2+subst:pl:voc:n2+subst:sg:gen:n2
poszerzenia	poszerzyć	ger:sg:gen:n2:perf:aff:refl.nonrefl
potrzeby	potrzeba	subst:pl:acc:f+subst:pl:nom:f+subst:pl:voc:f+subst:sg:gen:f
powagi	powaga	subst:pl:acc:f+subst:pl:nom:f+subst:pl:voc:f+subst:sg:gen:f
powrotu	powrót	subst:sg:gen:m3
powstania	powstanie	subst:pl:acc:n2+subst:pl:nom:n2+subst:pl:voc:n2+subst:sg:gen:n2
powstania	powstać	ger:sg:gen:n2:perf:aff:nonrefl
powszechnego	powszechny	adj:sg:acc:m1.m2:pos+adj:sg:gen:m1.m2.m3.n1.n2:pos
powszechnych	powszechny	adj:pl:acc:m1.p1:pos+adj:pl:gen:m1.m2.m3.f.n1.n2.p1.p2.p3:pos+adj:pl:loc:m1.m2.m3.f.n1.n2.p1.p2.p3:pos
poziomu	poziom	subst:sg:gen:m3
połowy	połowa	subst:pl:acc:f+subst:pl:nom:f+subst:pl:voc:f+subst:sg:gen:f
połowy	połów	subst:pl:acc:m3+subst:pl:nom:m3+subst:pl:voc:m3
położonego	położyć	ppas:sg:acc:m1.m2:perf:aff+ppas:sg:gen:m1.m2.m3.n1.n2:perf:aff
południowej	południowy	adj:sg:dat:f:pos+adj:sg:gen:f:pos+adj:sg:loc:f:pos
poźnych	-	-
prac	praca	subst:pl:gen:f
prac	prace	subst:pl:gen:p3
pracy	praca	subst:sg:dat:f+subst:sg:gen:f+subst:sg:loc:f
prania	pranie	subst:pl:acc:n2+subst:pl:nom:n2+subst:pl:voc:n2+subst:sg:gen:n2
prania	prać	ger:sg:gen:n2:imperf:aff:refl.nonrefl
prawa	prawa	subst:sg:nom:f+subst:sg:voc:f
prawa	prawo	subst:pl:acc:n2+subst:pl:nom:n2+subst:pl:voc:n2+subst:sg:gen:n2
prawa	prawy	adj:sg:nom.voc:f:pos
premiera	premiera	subst:sg:nom:f
premiera	premier	subst:sg:acc:m1+subst:sg:gen:m1
prezesa	prezes	subst:sg:acc:m1+subst:sg:gen:m1
prezydenta	prezydent	subst:sg:acc:m1+subst:sg:gen:m1
problemu	problem	subst:sg:gen:m3
produkcji	produkcja	subst:pl:gen:f+subst:sg:dat:f+subst:sg:gen:f+subst:sg:loc:f
programu	program	subst:sg:gen:m3
programów	program	subst:pl:gen:m3
projektu	projekt	subst:sg:gen:m3
prokuratury	prokuratura	subst:pl:acc:f+subst:pl:nom:f+subst:pl:voc:f+subst:sg:gen:f
propagowania	propagować	ger:sg:gen:n2:imperf:aff:refl.nonrefl
prostych	prosty	adj:pl:acc:m1.p1:pos+adj:pl:gen:m1.m2.m3.f.n1.n2.p1.p2.p3:pos+adj:pl:loc:m1.m2.m3.f.n1.n2.p1.p2.p3:pos+subst:pl:gen:m2+subst:pl:gen:m3+subst:pl:loc:m2+subst:pl:loc:m3
prostych	prosta	subst:pl:gen:f+subst:pl:loc:f
prywatnych	prywatny	adj:pl:acc:m1.p1:pos+adj:pl:gen:m1.m2.m3.f.n1.n2.p1.p2.p3:pos+adj:pl:loc:m1.m2.m3.f.n1.n2.p1.p2.p3:pos+subst:pl:acc:m1+subst:pl:gen:m1+subst:pl:loc:m1
przechodzących	przechodzący	adj:pl:acc:m1.p1:pos+adj:pl:gen:m1.m2.m3.f.n1.n2.p1.p2.p3:pos+adj:pl:loc:m1.m2.m3.f.n1.n2.p1.p2.p3:pos+subst:pl:acc:m1+subst:pl:gen:m1+subst:pl:loc:m1
przechodzących	przechodząca	subst:pl:gen:f+subst:pl:loc:f
przechodzących	przechodzić	pact:pl:acc:m1.p1:imperf:aff:nonrefl+pact:pl:acc:m1.p1:perf:aff:nonrefl+pact:pl:gen.loc:m1.m2.m3.f.n1.n2.p1.p2.p3:imperf:aff:nonrefl+pact:pl:gen.loc:m1.m2.m3.f.n1.n2.p1.p2.p3:perf:aff:nonrefl
przedawnienia	przedawnienie	subst:pl:acc:n2+subst:pl:nom:n2+subst:pl:voc:n2+subst:sg:gen:n2
przedawnienia	przedawnić	ger:sg:gen:n2:perf:aff:refl.nonrefl
przedstawienia	przedstawienie	subst:pl:acc:n2+subst:pl:nom:n2+subst:pl:voc:n2+subst:sg:gen:n2
przedstawienia	przedstawić	ger:sg:gen:n2:perf:aff:refl.nonrefl
przejęcia	przejęcie	subst:pl:acc:n2+subst:pl:nom:n2+subst:pl:voc:n2+subst:sg:gen:n2
przejęcia	przejąć	ger:sg:gen:n2:perf:aff:refl.nonrefl
przeksztalcenia	-	-
przemocy	przemoc	subst:pl:gen:f+subst:sg:dat:f+subst:sg:gen:f+subst:sg:loc:f+subst:sg:voc:f
przemówienia	przemówienie	subst:pl:acc:n2+subst:pl:nom:n2+subst:pl:voc:n2+subst:sg:gen:n2
przemówienia	przemówić	ger:sg:gen:n2:perf:aff:refl.nonrefl
przeniesienia	przeniesienie	subst:pl:acc:n2+subst:pl:nom:n2+subst:pl:voc:n2+subst:sg:gen:n2
przeniesienia	przenieść	ger:sg:gen:n2:perf:aff:refl.nonrefl
przenoszenia	przenosić	ger:sg:gen:n2:imperf:aff:refl.nonrefl
przeprowadzenia	przeprowadzić	ger:sg:gen:n2:perf:aff:refl.nonrefl
przerzucenia	przerzucić	ger:sg:gen:n2:perf:aff:refl.nonrefl
przestrzegania	przestrzegać	ger:sg:gen:n2:imperf:aff:refl.nonrefl
przestępstwa	przestępstwo	subst:pl:acc:n2+subst:pl:nom:n2+subst:pl:voc:n2+subst:sg:gen:n2
przewodniczacych	-	-
przewodniczącej	przewodnicząca	subst:sg:dat:f+subst:sg:gen:f+subst:sg:loc:f
przewodniczącej	przewodniczący	adj:sg:dat:f:pos+adj:sg:gen:f:pos+adj:sg:loc:f:pos
przewodniczącej	przewodniczyć	pact:sg:gen.dat.loc:f:imperf:aff:nonrefl
przełomu	przełom	subst:sg:gen:m3
przodu	przód	subst:sg:gen:m3
przyjęcia	przyjęcie	subst:pl:acc:n2+subst:pl:nom:n2+subst:pl:voc:n2+subst:sg:gen:n2
przyjęcia	przyjąć	ger:sg:gen:n2:perf:aff:refl.nonrefl
przykatedralnej	przykatedralny	adj:sg:dat:f:pos+adj:sg:gen:f:pos+adj:sg:loc:f:pos
przypadków	przypadek	subst:pl:gen:m3
przyspieszenia	przyspieszenie	subst:pl:acc:n2+subst:pl:nom:n2+subst:pl:voc:n2+subst:sg:gen:n2
przyspieszenia	przyspieszyć	ger:sg:gen:n2:perf:aff:refl.nonrefl
przywrócenia	przywrócić	ger:sg:gen:n2:perf:aff:refl.nonrefl
przywódców	przywódca	subst:pl:acc:m1+subst:pl:gen:m1
publicznej	publiczny	adj:sg:dat:f:pos+adj:sg:gen:f:pos+adj:sg:loc:f:pos
pucharu	puchar	subst:sg:gen:m3
punktacji	punktacja	subst:pl:gen:f+subst:sg:dat:f+subst:sg:gen:f+subst:sg:loc:f
półfinału	półfinał	subst:sg:gen:m3
półfinałów	półfinał	subst:pl:gen:m3
rad	rad	adj:sg:nom:m1.m2.m3:pos+subst:sg:acc:m3+subst:sg:nom:m3
rad	rada	subst:pl:gen:f
rady	rad	subst:pl:acc:m3+subst:pl:nom:m3+subst:pl:voc:m3
rady	rada	subst:pl:acc:f+subst:pl:nom:f+subst:pl:voc:f+subst:sg:gen:f
rannego	ranny	adj:sg:acc:m1.m2:pos+adj:sg:gen:m1.m2.m3.n1.n2:pos+subst:sg:acc:m1+subst:sg:gen:m1
raportu	raport	subst:sg:gen:m3
redakcji	redakcja	subst:pl:gen:f+subst:sg:dat:f+subst:sg:gen:f+subst:sg:loc:f
redukcji	redukcja	subst:pl:gen:f+subst:sg:dat:f+subst:sg:gen:f+subst:sg:loc:f
reelekcji	reelekcja	subst:pl:gen:f+subst:sg:dat:f+subst:sg:gen:f+subst:sg:loc:f
reformy	reformy	subst:pl:acc:p3+subst:pl:nom:p3+subst:pl:voc:p3
reformy	reforma	subst:pl:acc:f+subst:pl:nom:f+subst:pl:voc:f+subst:sg:gen:f
regionu	region	subst:sg:gen:m3
regul	-	-
rejestru	rejestr	subst:sg:gen:m3
reklamy	reklamy	subst:pl:acc:p3+subst:pl:nom:p3+subst:pl:voc:p3
reklamy	reklama	subst:pl:acc:f+subst:pl:nom:f+subst:pl:voc:f+subst:sg:gen:f
rekompensat	rekompensata	subst:pl:gen:f
rekordowych	rekordowy	adj:pl:acc:m1.p1:pos+adj:pl:gen:m1.m2.m3.f.n1.n2.p1.p2.p3:pos+adj:pl:loc:m1.m2.m3.f.n1.n2.p1.p2.p3:pos
reprezentacji	reprezentacja	subst:pl:gen:f+subst:sg:dat:f+subst:sg:gen:f+subst:sg:loc:f
republikanskiej	-	-
resortu	resort	subst:sg:gen:m3
retoryki	retoryk	depr:pl:nom:m2+depr:pl:voc:m2
retoryki	retoryka	subst:pl:acc:f+subst:pl:nom:f+subst:pl:voc:f+subst:sg:gen:f
rezygnacji	rezygnacja	subst:pl:gen:f+subst:sg:dat:f+subst:sg:gen:f+subst:sg:loc:f
robienia	robić	ger:sg:gen:n2:imperf:aff:refl.nonrefl
rokowań	rokowania	subst:pl:gen:p3
rokowań	rokowanie	subst:pl:gen:n2
roku	rok	subst:sg:gen:m3+subst:sg:loc:m3+subst:sg:voc:m3
roli	rola	subst:sg:dat:f
roli	rola	subst:sg:gen:f
roli	rola	subst:sg:loc:f
rosji	-	-
rosyjskich	rosyjski	adj:pl:acc:m1.p1:pos+adj:pl:gen:m1.m2.m3.f.n1.n2.p1.p2.p3:pos+adj:pl:loc:m1.m2.m3.f.n1.n2.p1.p2.p3:pos+subst:pl:gen:m3+subst:pl:loc:m3
rozdziału	rozdział	subst:sg:gen:m3
rozgrywek	rozgrywka	subst:pl:gen:f
rozgrywek	rozgrywki	subst:pl:gen:p3
rozmów	rozmówić	verb:impt:sg:sec:perf:refl
rozmów	rozmowa	subst:pl:gen:f
rozmów	rozmowy	subst:pl:gen:p3
rozpamiętywania	rozpamiętywać	ger:sg:gen:n2:imperf:aff:refl.nonrefl
rozpatrzenia	rozpatrzenie	subst:pl:acc:n2+subst:pl:nom:n2+subst:pl:voc:n2+subst:sg:gen:n2
rozpatrzenia	rozpatrzeć	ger:sg:gen:n2:perf:aff:nonrefl
rozpatrzenia	rozpatrzyć	ger:sg:gen:n2:perf:aff:refl.nonrefl
rozpoczęcia	rozpoczęcie	subst:pl:acc:n2+subst:pl:nom:n2+subst:pl:voc:n2+subst:sg:gen:n2
rozpoczęcia	rozpocząć	ger:sg:gen:n2:perf:aff:refl.nonrefl
rozwiązania	rozwiązanie	subst:pl:acc:n2+subst:pl:nom:n2+subst:pl:voc:n2+subst:sg:gen:n2
rozwiązania	rozwiązać	ger:sg:gen:n2:perf:aff:refl.nonrefl
rozwoju	rozwój	subst:sg:gen:m3+subst:sg:loc:m3+subst:sg:voc:m3
rywalizacji	rywalizacja	subst:pl:gen:f+subst:sg:dat:f+subst:sg:gen:f+subst:sg:loc:f
rzecznika	rzecznik	subst:sg:acc:m1+subst:sg:gen:m1
rzeszy	rzesza	subst:sg:dat:f
rzeszy	rzesza	subst:sg:gen:f
rzeszy	rzesza	subst:sg:loc:f
rzymu	-	-
rządu	rząd	subst:sg:gen:m3
równinnej	równinny	adj:sg:dat:f:pos+adj:sg:gen:f:pos+adj:sg:loc:f:pos
sadu	sad	subst:sg:gen:m3
saint	-	-
san	san	subst:sg:acc:m3
san	san	subst:sg:nom:m3
sasiadujacej	-	-
secesji	secesja	subst:pl:gen:f+subst:sg:dat:f+subst:sg:gen:f+subst:sg:loc:f
sejmu	sejm	subst:sg:gen:m3
sektora	sektor	subst:sg:gen:m3
senatu	senat	subst:sg:gen:m3
seulu	-	-
sformułowania	sformułowanie	subst:pl:acc:n2+subst:pl:nom:n2+subst:pl:voc:n2+subst:sg:gen:n2
sformułowania	sformułować	ger:sg:gen:n2:perf:aff:refl.nonrefl
sharm	-	-
siebie	się	siebie:acc+siebie:gen
sieci	sieć	subst:pl:acc:f+subst:pl:gen:f+subst:pl:nom:f+subst:pl:voc:f+subst:sg:dat:f+subst:sg:gen:f+subst:sg:loc:f+subst:sg:voc:f
siedmiu	siedem	num:pl:acc:m1:rec+num:pl:gen.dat.inst.loc:m1.m2.m3.f.n2:congr+num:pl:nom.voc:m1:rec
siedziby	siedziba	subst:pl:acc:f+subst:pl:nom:f+subst:pl:voc:f+subst:sg:gen:f
sisteron	-	-
skażenia	skażenie	subst:pl:acc:n2+subst:pl:nom:n2+subst:pl:voc:n2+subst:sg:gen:n2
skażenia	skazić	ger:sg:gen:n2:perf:aff:refl.nonrefl
skl	-	-
sklepów	sklep	subst:pl:gen:m3
slow	-	-
soboty	sobota	subst:pl:acc:f
soboty	sobota	subst:pl:nom:f
soboty	sobota	subst:pl:voc:f
soboty	sobota	subst:sg:gen:f
sojuszników	sojusznik	subst:pl:acc:m1+subst:pl:gen:m1
sojuszu	sojusz	subst:sg:gen:m3+subst:sg:loc:m3+subst:sg:voc:m3
spokoju	spokój	subst:sg:gen:m3+subst:sg:loc:m3+subst:sg:voc:m3
spornego	sporny	adj:sg:acc:m1.m2:pos+adj:sg:gen:m1.m2.m3.n1.n2:pos+subst:sg:acc:m1+subst:sg:gen:m1
sporządzenia	sporządzić	ger:sg:gen:n2:perf:aff:refl.nonrefl
spotkania	spotkanie	subst:pl:acc:n2+subst:pl:nom:n2+subst:pl:voc:n2+subst:sg:gen:n2
spotkania	spotkać	ger:sg:gen:n2:perf:aff:refl.nonrefl
spozycia	-	-
społeczności	społeczność	subst:pl:acc:f+subst:pl:gen:f+subst:pl:nom:f+subst:pl:voc:f+subst:sg:dat:f+subst:sg:gen:f+subst:sg:loc:f+subst:sg:voc:f
spraw	sprawa	subst:pl:gen:f
spraw	sprawić	verb:impt:sg:sec:perf:refl.nonrefl
sprawiedliwości	sprawiedliwość	subst:pl:acc:f+subst:pl:gen:f+subst:pl:nom:f+subst:pl:voc:f+subst:sg:dat:f+subst:sg:gen:f+subst:sg:loc:f+subst:sg:voc:f
sprawy	sprawa	subst:pl:acc:f+subst:pl:nom:f+subst:pl:voc:f+subst:sg:gen:f
sprzedaży	sprzedaż	subst:pl:gen:f+subst:sg:dat:f+subst:sg:gen:f+subst:sg:loc:f+subst:sg:voc:f
spółki	spółka	subst:pl:acc:f+subst:pl:nom:f+subst:pl:voc:f+subst:sg:gen:f
st	stacja	brev:pun
st	stołeczny	brev:pun
stabilizacji	stabilizacja	subst:pl:gen:f+subst:sg:dat:f+subst:sg:gen:f+subst:sg:loc:f
stacji	stacja	subst:pl:gen:f+subst:sg:dat:f+subst:sg:gen:f+subst:sg:loc:f
standardów	standard	subst:pl:gen:m3
stanow	-	-
starosty	starosta	depr:pl:nom:m2
starosty	starosta	depr:pl:voc:m2
starosty	starosta	subst:sg:gen:m1
starć	starcie	subst:pl:gen:n2
statutu	statut	subst:sg:gen:m3
stawianych	stawiać	ppas:pl:acc:m1.p1:imperf:aff+ppas:pl:gen.loc:m1.m2.m3.f.n1.n2.p1.p2.p3:imperf:aff
stopnia	stopień	subst:sg:gen:m3
stołu	stół	subst:sg:gen:m3
strajku	strajk	subst:sg:gen:m3+subst:sg:loc:m3+subst:sg:voc:m3
strasburga	-	-
stron	strona	subst:pl:gen:f
strony	strona	subst:pl:acc:f+subst:pl:nom:f+subst:pl:voc:f+subst:sg:gen:f
strzelaniny	strzelanina	subst:pl:acc:f+subst:pl:nom:f+subst:pl:voc:f+subst:sg:gen:f
stworzenia	stworzenie	subst:pl:acc:n2+subst:pl:nom:n2+subst:pl:voc:n2+subst:sg:gen:n2
stworzenia	stworzyć	ger:sg:gen:n2:perf:aff:refl.nonrefl
styczniowego	styczniowy	adj:sg:acc:m1.m2:pos+adj:sg:gen:m1.m2.m3.n1.n2:pos
swego	swój	adj:sg:acc:m1.m2:pos+adj:sg:gen:m1.m2.m3.n1.n2:pos
swoich	swoje	subst:pl:gen:n2+subst:pl:loc:n2
swoich	swój	adj:pl:acc:m1.p1:pos+adj:pl:gen:m1.m2.m3.f.n1.n2.p1.p2.p3:pos+adj:pl:loc:m1.m2.m3.f.n1.n2.p1.p2.p3:pos
swojej	swój	adj:sg:dat:f:pos+adj:sg:gen:f:pos+adj:sg:loc:f:pos
swych	swój	adj:pl:acc:m1.p1:pos+adj:pl:gen:m1.m2.m3.f.n1.n2.p1.p2.p3:pos+adj:pl:loc:m1.m2.m3.f.n1.n2.p1.p2.p3:pos
systemu	system	subst:sg:gen:m3
sytuacji	sytuacja	subst:pl:gen:f+subst:sg:dat:f+subst:sg:gen:f+subst:sg:loc:f
szefa	szef	subst:sg:acc:m1+subst:sg:gen:m1
szesciu	-	-
szpitala	szpital	subst:sg:gen:m3
sztabu	sztab	subst:sg:gen:m3
szwajcarii	-	-
sądu	sąd	subst:sg:gen:m3
sądów	sąd	subst:pl:gen:m3
służby	służba	subst:pl:acc:f+subst:pl:nom:f+subst:pl:voc:f+subst:sg:gen:f
takich	taki	adj:pl:acc:m1.p1:pos+adj:pl:gen:m1.m2.m3.f.n1.n2.p1.p2.p3:pos+adj:pl:loc:m1.m2.m3.f.n1.n2.p1.p2.p3:pos
takiego	taki	adj:sg:acc:m1.m2:pos+adj:sg:gen:m1.m2.m3.n1.n2:pos
takiej	taki	adj:sg:dat:f:pos+adj:sg:gen:f:pos+adj:sg:loc:f:pos
teatru	teatr	subst:sg:gen:m3
tego	ten	adj:sg:acc:m1.m2:pos+adj:sg:gen:m1.m2.m3.n1.n2:pos
tego	to	subst:sg:gen:n2
tegorocznego	tegoroczny	adj:sg:acc:m1.m2:pos+adj:sg:gen:m1.m2.m3.n1.n2:pos
tej	ten	adj:sg:dat:f:pos+adj:sg:gen:f:pos+adj:sg:loc:f:pos
tekstu	tekst	subst:sg:gen:m3
tel	telefon	brev:pun
tenisa	tenis	subst:sg:acc:m2+subst:sg:gen:m2+subst:sg:gen:m3
terenowych	terenowy	adj:pl:acc:m1.p1:pos+adj:pl:gen:m1.m2.m3.f.n1.n2.p1.p2.p3:pos+adj:pl:loc:m1.m2.m3.f.n1.n2.p1.p2.p3:pos
toalety	toaleta	subst:pl:acc:f+subst:pl:nom:f+subst:pl:voc:f+subst:sg:gen:f
tokijskiego	tokijski	adj:sg:acc:m1.m2:pos+adj:sg:gen:m1.m2.m3.n1.n2:pos
torricella	-	-
tradycyjnego	tradycyjny	adj:sg:acc:m1.m2:pos+adj:sg:gen:m1.m2.m3.n1.n2:pos
tragedii	tragedia	subst:pl:gen:f+subst:sg:dat:f+subst:sg:gen:f+subst:sg:loc:f
transakcji	transakcja	subst:pl:gen:f+subst:sg:dat:f+subst:sg:gen:f+subst:sg:loc:f
transfuzji	transfuzja	subst:pl:gen:f+subst:sg:dat:f+subst:sg:gen:f+subst:sg:loc:f
treści	treści	subst:pl:acc:p3+subst:pl:gen:p3+subst:pl:nom:p3+subst:pl:voc:p3
treści	treść	subst:pl:acc:f+subst:pl:gen:f+subst:pl:nom:f+subst:pl:voc:f+subst:sg:dat:f+subst:sg:gen:f+subst:sg:loc:f+subst:sg:voc:f
triathlonu	triathlon	subst:sg:gen:m3
trybunału	trybunał	subst:sg:gen:m3
tunelu	tunel	subst:sg:gen:m3+subst:sg:loc:m3+subst:sg:voc:m3
turnieju	turniej	subst:sg:gen:m3+subst:sg:loc:m3+subst:sg:voc:m3
twórczości	twórczość	subst:pl:acc:f+subst:pl:gen:f+subst:pl:nom:f+subst:pl:voc:f+subst:sg:dat:f+subst:sg:gen:f+subst:sg:loc:f+subst:sg:voc:f
tych	ten	adj:pl:acc:m1.p1:pos+adj:pl:gen:m1.m2.m3.f.n1.n2.p1.p2.p3:pos+adj:pl:loc:m1.m2.m3.f.n1.n2.p1.p2.p3:pos
ubieglorocznej	-	-
udziału	udział	subst:sg:gen:m3
ue	-	-
ukraińskiego	ukraiński	adj:sg:acc:m1.m2:pos+adj:sg:gen:m1.m2.m3.n1.n2:pos+subst:sg:gen:m3
uleglosci	-	-
umieszczenia	umieścić	ger:sg:gen:n2:perf:aff:refl.nonrefl
umocnienia	umocnienie	subst:pl:acc:n2+subst:pl:nom:n2+subst:pl:voc:n2+subst:sg:gen:n2
umocnienia	umocnić	ger:sg:gen:n2:perf:aff:refl.nonrefl
umowy	umowy	adj:sg:acc:m3:pos+adj:sg:nom.voc:m1.m2.m3:pos
umowy	umowa	subst:pl:acc:f+subst:pl:nom:f+subst:pl:voc:f+subst:sg:gen:f
unii	unia	subst:pl:gen:f+subst:sg:dat:f+subst:sg:gen:f+subst:sg:loc:f
unijnych	unijny	adj:pl:acc:m1.p1:pos+adj:pl:gen:m1.m2.m3.f.n1.n2.p1.p2.p3:pos+adj:pl:loc:m1.m2.m3.f.n1.n2.p1.p2.p3:pos
ur	urodzony	brev:pun
urzędu	urząd	subst:sg:gen:m3
urzędów	urząd	subst:pl:gen:m3
usa	-	-
ustawy	ustawa	subst:pl:acc:f+subst:pl:nom:f+subst:pl:voc:f+subst:sg:gen:f
ustąpienia	ustąpienie	subst:pl:acc:n2+subst:pl:nom:n2+subst:pl:voc:n2+subst:sg:gen:n2
ustąpienia	ustąpić	ger:sg:gen:n2:perf:aff:refl+ger:sg:gen:n2:perf:aff:refl.nonrefl
utraty	utrata	subst:pl:acc:f
utraty	utrata	subst:pl:nom:f
utraty	utrata	subst:pl:voc:f
utraty	utrata	subst:sg:gen:f
uwolnienia	uwolnić	ger:sg:gen:n2:perf:aff:refl.nonrefl
użytku	użytek	subst:sg:gen:m3+subst:sg:loc:m3+subst:sg:voc:m3
villeneuve	-	-
wagarowania	wagarować	ger:sg:gen:n2:imperf:aff:nonrefl
wajdy	-	-
walki	walka	subst:pl:acc:f+subst:pl:nom:f+subst:pl:voc:f+subst:sg:gen:f
walorów	walor	subst:pl:gen:m3
walorów	walory	subst:pl:gen:p3
warszawskiej	warszawski	adj:sg:dat:f:pos+adj:sg:gen:f:pos+adj:sg:loc:f:pos
warszawy	warszawa	subst:pl:acc:f
warszawy	warszawa	subst:pl:nom:f
warszawy	warszawa	subst:pl:voc:f
warszawy	warszawa	subst:sg:gen:f
wdzięczności	wdzięczność	subst:pl:acc:f+subst:pl:gen:f+subst:pl:nom:f+subst:pl:voc:f+subst:sg:dat:f+subst:sg:gen:f+subst:sg:loc:f+subst:sg:voc:f
wejścia	wejście	subst:pl:acc:n2+subst:pl:nom:n2+subst:pl:voc:n2+subst:sg:gen:n2
wejścia	wejść	ger:sg:gen:n2:perf:aff:nonrefl
wiadomości	wiadomości	subst:pl:acc:p3+subst:pl:gen:p3+subst:pl:nom:p3+subst:pl:voc:p3
wiadomości	wiadomość	subst:pl:acc:f+subst:pl:gen:f+subst:pl:nom:f+subst:pl:voc:f+subst:sg:dat:f+subst:sg:gen:f+subst:sg:loc:f+subst:sg:voc:f
wiatru	wiatr	subst:sg:gen:m3
wiednia	-	-
wielkiej	wielki	adj:sg:dat:f:pos+adj:sg:gen:f:pos+adj:sg:loc:f:pos
wiezienia	wieźć	ger:sg:gen:n2:imperf:aff:refl.nonrefl
wilna	-	-
winy	wina	subst:pl:acc:f+subst:pl:nom:f+subst:pl:voc:f+subst:sg:gen:f
wiosennej	wiosenny	adj:sg:dat:f:pos+adj:sg:gen:f:pos+adj:sg:loc:f:pos
większej	wielki	adj:sg:dat:f:com+adj:sg:gen:f:com+adj:sg:loc:f:com
większej	duży	adj:sg:dat:f:com+adj:sg:gen:f:com+adj:sg:loc:f:com
wladzy	-	-
wniosku	wniosek	subst:sg:gen:m3+subst:sg:loc:m3+subst:sg:voc:m3
wody	woda	subst:pl:acc:f+subst:pl:nom:f+subst:pl:voc:f+subst:sg:gen:f
wojewódzkiego	wojewódzki	adj:sg:acc:m1.m2:pos+adj:sg:gen:m1.m2.m3.n1.n2:pos
wojska	wojska	subst:sg:nom:f+subst:sg:voc:f
wojska	wojsko	subst:pl:acc:n2+subst:pl:nom:n2+subst:pl:voc:n2+subst:sg:gen:n2
wojskowego	wojskowy	adj:sg:acc:m1.m2:pos+adj:sg:gen:m1.m2.m3.n1.n2:pos+subst:sg:acc:m1+subst:sg:gen:m1
wokółziemskich	wokółziemski	adj:pl:acc:m1.p1:pos+adj:pl:gen:m1.m2.m3.f.n1.n2.p1.p2.p3:pos+adj:pl:loc:m1.m2.m3.f.n1.n2.p1.p2.p3:pos
wolności	wolność	subst:pl:acc:f+subst:pl:gen:f+subst:pl:nom:f+subst:pl:voc:f+subst:sg:dat:f+subst:sg:gen:f+subst:sg:loc:f+subst:sg:voc:f
wpływu	wpływ	subst:sg:gen:m3
wrocławia	-	-
września	września	subst:sg:nom:f
września	wrzesień	subst:sg:gen:m3
wspolpracy	-	-
wspólnego	wspólny	adj:sg:acc:m1.m2:pos+adj:sg:gen:m1.m2.m3.n1.n2:pos
wspólnoty	wspólnota	subst:pl:acc:f+subst:pl:nom:f+subst:pl:voc:f+subst:sg:gen:f
współdecydowania	współdecydować	ger:sg:gen:n2:imperf:aff:nonrefl
współpracy	współpraca	subst:sg:dat:f+subst:sg:gen:f+subst:sg:loc:f
współracy	-	-
wstrząsających	wstrząsający	adj:pl:acc:m1.p1:pos+adj:pl:gen:m1.m2.m3.f.n1.n2.p1.p2.p3:pos+adj:pl:loc:m1.m2.m3.f.n1.n2.p1.p2.p3:pos
wstrząsających	wstrząsać	pact:pl:acc:m1.p1:imperf:aff:refl.nonrefl+pact:pl:gen.loc:m1.m2.m3.f.n1.n2.p1.p2.p3:imperf:aff:refl.nonrefl
wszystkich	wszystek	adj:pl:acc:m1.p1:pos+adj:pl:gen:m1.m2.m3.f.n1.n2.p1.p2.p3:pos+adj:pl:loc:m1.m2.m3.f.n1.n2.p1.p2.p3:pos
wszystkich	wszyscy	subst:pl:acc:p1+subst:pl:gen:p1+subst:pl:loc:p1
wtorkowego	wtorkowy	adj:sg:acc:m1.m2:pos+adj:sg:gen:m1.m2.m3.n1.n2:pos
wtorku	wtorek	subst:sg:gen:m3+subst:sg:loc:m3+subst:sg:voc:m3
wyborow	-	-
wyboru	wybór	subst:sg:gen:m3
wyborów	wybory	subst:pl:gen:p3
wyborów	wybór	subst:pl:gen:m3
wybranych	wybrany	adj:pl:acc:m1.p1:pos+adj:pl:gen:m1.m2.m3.f.n1.n2.p1.p2.p3:pos+adj:pl:loc:m1.m2.m3.f.n1.n2.p1.p2.p3:pos+subst:pl:acc:m1+subst:pl:gen:m1+subst:pl:loc:m1
wybranych	wybrana	subst:pl:gen:f+subst:pl:loc:f
wybranych	wybrać	ppas:pl:acc:m1.p1:perf:aff+ppas:pl:gen.loc:m1.m2.m3.f.n1.n2.p1.p2.p3:perf:aff
wycofania	wycofanie	subst:pl:acc:n2+subst:pl:nom:n2+subst:pl:voc:n2+subst:sg:gen:n2
wycofania	wycofać	ger:sg:gen:n2:perf:aff:refl.nonrefl
wyeliminowania	wyeliminowanie	subst:pl:acc:n2+subst:pl:nom:n2+subst:pl:voc:n2+subst:sg:gen:n2
wyeliminowania	wyeliminować	ger:sg:gen:n2:perf:aff:refl.nonrefl
wyhamowania	wyhamować	ger:sg:gen:n2:perf:aff:refl.nonrefl
wyjazdu	wyjazd	subst:sg:gen:m3
wykonywania	wykonywać	ger:sg:gen:n2:imperf:aff:refl.nonrefl
wykrywania	wykrywać	ger:sg:gen:n2:imperf:aff:refl.nonrefl
wymagań	wymaganie	subst:pl:gen:n2
wymogów	wymóg	subst:pl:gen:m3
wynagrodzenia	wynagrodzenie	subst:pl:acc:n2+subst:pl:nom:n2+subst:pl:voc:n2+subst:sg:gen:n2
wynagrodzenia	wynagrodzić	ger:sg:gen:n2:perf:aff:refl.nonrefl
wynegocjowania	wynegocjować	ger:sg:gen:n2:perf:aff:refl.nonrefl
wyników	wynik	subst:pl:gen:m3
wypadów	wypad	subst:pl:gen:m3
wypelnienienia	-	-
wyprzedaży	wyprzedaż	subst:pl:gen:f+subst:sg:dat:f+subst:sg:gen:f+subst:sg:loc:f+subst:sg:voc:f
wypuszczenia	wypuścić	ger:sg:gen:n2:perf:aff:refl.nonrefl
wypłukiwania	wypłukiwać	ger:sg:gen:n2:imperf:aff:refl.nonrefl
wyraźnego	wyraźny	adj:sg:acc:m1.m2:pos+adj:sg:gen:m1.m2.m3.n1.n2:pos
wyrównania	wyrównanie	subst:pl:acc:n2+subst:pl:nom:n2+subst:pl:voc:n2+subst:sg:gen:n2
wyrównania	wyrównać	ger:sg:gen:n2:perf:aff:refl.nonrefl
wysokości	wysokość	subst:pl:acc:f+subst:pl:gen:f+subst:pl:nom:f+subst:pl:voc:f+subst:sg:dat:f+subst:sg:gen:f+subst:sg:loc:f+subst:sg:voc:f
wysypania	wysypać	ger:sg:gen:n2:perf:aff:refl.nonrefl
wywierania	wywierać	ger:sg:gen:n2:imperf:aff:refl.nonrefl
wyznaczania	wyznaczać	ger:sg:gen:n2:imperf:aff:refl.nonrefl
wyznania	wyznanie	subst:pl:acc:n2+subst:pl:nom:n2+subst:pl:voc:n2+subst:sg:gen:n2
wyznania	wyznać	ger:sg:gen:n2:perf:aff:refl.nonrefl
wyłonienia	wyłonić	ger:sg:gen:n2:perf:aff:refl.nonrefl
wzajemnego	wzajemny	adj:sg:acc:m1.m2:pos+adj:sg:gen:m1.m2.m3.n1.n2:pos
wzmocnienia	wzmocnienie	subst:pl:acc:n2+subst:pl:nom:n2+subst:pl:voc:n2+subst:sg:gen:n2
wzmocnienia	wzmocnić	ger:sg:gen:n2:perf:aff:refl.nonrefl
węgla	węgiel	subst:sg:gen:m3
władz	władza	subst:pl:gen:f
władzy	władza	subst:sg:dat:f+subst:sg:gen:f+subst:sg:loc:f
własnego	własne	subst:sg:gen:n2
własnego	własny	adj:sg:acc:m1.m2:pos+adj:sg:gen:m1.m2.m3.n1.n2:pos
własnościowych	własnościowy	adj:pl:acc:m1.p1:pos+adj:pl:gen:m1.m2.m3.f.n1.n2.p1.p2.p3:pos+adj:pl:loc:m1.m2.m3.f.n1.n2.p1.p2.p3:pos
własnych	własny	adj:pl:acc:m1.p1:pos+adj:pl:gen:m1.m2.m3.f.n1.n2.p1.p2.p3:pos+adj:pl:loc:m1.m2.m3.f.n1.n2.p1.p2.p3:pos
własnych	własne	subst:pl:gen:n2+subst:pl:loc:n2
włoch	-	-
xix	-	-
yad	-	-
zaakceptowania	zaakceptować	ger:sg:gen:n2:perf:aff:refl.nonrefl
zabezpieczenia	zabezpieczenie	subst:pl:acc:n2+subst:pl:nom:n2+subst:pl:voc:n2+subst:sg:gen:n2
zabezpieczenia	zabezpieczyć	ger:sg:gen:n2:perf:aff:refl.nonrefl
zabójstwa	zabójstwo	subst:pl:acc:n2+subst:pl:nom:n2+subst:pl:voc:n2+subst:sg:gen:n2
zachodnich	zachodni	adj:pl:acc:m1.p1:pos+adj:pl:gen:m1.m2.m3.f.n1.n2.p1.p2.p3:pos+adj:pl:loc:m1.m2.m3.f.n1.n2.p1.p2.p3:pos
zachodniej	zachodni	adj:sg:dat:f:pos+adj:sg:gen:f:pos+adj:sg:loc:f:pos
zachowania	zachowanie	subst:pl:acc:n2+subst:pl:nom:n2+subst:pl:voc:n2+subst:sg:gen:n2
zachowania	zachować	ger:sg:gen:n2:perf:aff:refl.nonrefl
zaciętych	zacięty	adj:pl:acc:m1.p1:pos+adj:pl:gen:m1.m2.m3.f.n1.n2.p1.p2.p3:pos+adj:pl:loc:m1.m2.m3.f.n1.n2.p1.p2.p3:pos
zaciętych	zaciąć	ppas:pl:acc:m1.p1:perf:aff+ppas:pl:gen.loc:m1.m2.m3.f.n1.n2.p1.p2.p3:perf:aff
zadania	zadanie	subst:pl:acc:n2+subst:pl:nom:n2+subst:pl:voc:n2+subst:sg:gen:n2
zadania	zadać	ger:sg:gen:n2:perf:aff:refl.nonrefl
zadzwonienia	zadzwonić	ger:sg:gen:n2:perf:aff:nonrefl
zakończenia	zakończenie	subst:pl:acc:n2+subst:pl:nom:n2+subst:pl:voc:n2+subst:sg:gen:n2
zakończenia	zakończyć	ger:sg:gen:n2:perf:aff:refl.nonrefl
zakupu	zakup	subst:sg:gen:m3
zalatwienia	-	-
zamachu	zamach	subst:sg:gen:m3+subst:sg:loc:m3+subst:sg:voc:m3
zamordowania	zamordować	ger:sg:gen:n2:perf:aff:refl.nonrefl
zaognienia	zaognienie	subst:pl:acc:n2+subst:pl:nom:n2+subst:pl:voc:n2+subst:sg:gen:n2
zaognienia	zaognić	ger:sg:gen:n2:perf:aff:refl.nonrefl
zapadania	zapadać	ger:sg:gen:n2:imperf:aff:refl.nonrefl+ger:sg:gen:n2:perf:aff:nonrefl
zapewnienia	zapewnienie	subst:pl:acc:n2+subst:pl:nom:n2+subst:pl:voc:n2+subst:sg:gen:n2
zapewnienia	zapewnić	ger:sg:gen:n2:perf:aff:refl.nonrefl
zapisu	zapis	subst:sg:gen:m3
zapoznania	zapoznać	ger:sg:gen:n2:perf:aff:refl.nonrefl
zaprzestania	zaprzestanie	subst:pl:acc:n2+subst:pl:nom:n2+subst:pl:voc:n2+subst:sg:gen:n2
zaprzestania	zaprzestać	ger:sg:gen:n2:perf:aff:nonrefl
zapłacenia	zapłacić	ger:sg:gen:n2:perf:aff:refl.nonrefl
zarejestrowania	zarejestrować	ger:sg:gen:n2:perf:aff:refl.nonrefl
zarzucenia	zarzucić	ger:sg:gen:n2:perf:aff:refl.nonrefl
zarzutów	zarzut	subst:pl:gen:m3
zatrzymanych	zatrzymany	adj:pl:acc:m1.p1:pos+adj:pl:gen:m1.m2.m3.f.n1.n2.p1.p2.p3:pos+adj:pl:loc:m1.m2.m3.f.n1.n2.p1.p2.p3:pos+subst:pl:acc:m1+subst:pl:gen:m1+subst:pl:loc:m1
zatrzymanych	zatrzymana	subst:pl:gen:f+subst:pl:loc:f
zatrzymanych	zatrzymać	ppas:pl:acc:m1.p1:perf:aff+ppas:pl:gen.loc:m1.m2.m3.f.n1.n2.p1.p2.p3:perf:aff
załatwienia	załatwienie	subst:pl:acc:n2+subst:pl:nom:n2+subst:pl:voc:n2+subst:sg:gen:n2
załatwienia	załatwić	ger:sg:gen:n2:perf:aff:refl.nonrefl
zbadania	zbadanie	subst:pl:acc:n2+subst:pl:nom:n2+subst:pl:voc:n2+subst:sg:gen:n2
zbadania	zbadać	ger:sg:gen:n2:perf:aff:refl.nonrefl
zbrodni	zbrodnia	subst:pl:gen:f+subst:sg:dat:f+subst:sg:gen:f+subst:sg:loc:f
zbrodni	zbrodzień	subst:pl:acc:m1+subst:pl:gen:m1
zbudowania	zbudować	ger:sg:gen:n2:perf:aff:refl.nonrefl
zbyt	zbyt	adv+subst:sg:acc:m3+subst:sg:nom:m3
zdecydowanego	zdecydowany	adj:sg:acc:m1.m2:pos+adj:sg:gen:m1.m2.m3.n1.n2:pos
zdecydowanego	zdecydować	ppas:sg:acc:m1.m2:perf:aff+ppas:sg:gen:m1.m2.m3.n1.n2:perf:aff
zdelegalizowania	zdelegalizować	ger:sg:gen:n2:perf:aff:refl.nonrefl
zdjęcia	zdjęcia	subst:pl:acc:p3+subst:pl:nom:p3+subst:pl:voc:p3
zdjęcia	zdjęcie	subst:pl:acc:n2+subst:pl:nom:n2+subst:pl:voc:n2+subst:sg:gen:n2
zdjęcia	zdjąć	ger:sg:gen:n2:perf:aff:refl.nonrefl
zdobycia	zdobycie	subst:pl:acc:n2+subst:pl:nom:n2+subst:pl:voc:n2+subst:sg:gen:n2
zdobycia	zdobyć	ger:sg:gen:n2:perf:aff:refl.nonrefl
zdominowania	zdominować	ger:sg:gen:n2:perf:aff:refl.nonrefl
zdrowia	zdrowie	subst:pl:acc:n2+subst:pl:nom:n2+subst:pl:voc:n2+subst:sg:gen:n2
zerwania	zerwanie	subst:pl:acc:n2+subst:pl:nom:n2+subst:pl:voc:n2+subst:sg:gen:n2
zerwania	zerwać	ger:sg:gen:n2:perf:aff:refl.nonrefl
zerówki	zerówka	subst:pl:acc:f+subst:pl:nom:f+subst:pl:voc:f+subst:sg:gen:f
zespołu	zespół	subst:sg:gen:m3
zespołów	zespół	subst:pl:gen:m3
zgromadzenia	zgromadzenie	subst:pl:acc:n2+subst:pl:nom:n2+subst:pl:voc:n2+subst:sg:gen:n2
zgromadzenia	zgromadzić	ger:sg:gen:n2:perf:aff:refl.nonrefl
ziemi	ziemia	subst:sg:dat:f
ziemi	ziemia	subst:sg:gen:f
ziemi	ziemia	subst:sg:loc:f
zjednoczenia	zjednoczenie	subst:pl:acc:n2+subst:pl:nom:n2+subst:pl:voc:n2+subst:sg:gen:n2
zjednoczenia	zjednoczyć	ger:sg:gen:n2:perf:aff:refl.nonrefl
zmian	zmiana	subst:pl:gen:f
zmiany	zmiana	subst:pl:acc:f+subst:pl:nom:f+subst:pl:voc:f+subst:sg:gen:f
znacznie	znacznie	adv+adv:pos
zniszczenia	zniszczenie	subst:pl:acc:n2+subst:pl:nom:n2+subst:pl:voc:n2+subst:sg:gen:n2
zniszczenia	zniszczeć	ger:sg:gen:n2:perf:aff:nonrefl
zniszczenia	zniszczyć	ger:sg:gen:n2:perf:aff:refl.nonrefl
zwartego	zwarty	adj:sg:acc:m1.m2:pos+adj:sg:gen:m1.m2.m3.n1.n2:pos
zwartego	zewrzeć	ppas:sg:acc:m1.m2:perf:aff+ppas:sg:gen:m1.m2.m3.n1.n2:perf:aff
zwiększenia	zwiększenie	subst:pl:acc:n2+subst:pl:nom:n2+subst:pl:voc:n2+subst:sg:gen:n2
zwiększenia	zwiększyć	ger:sg:gen:n2:perf:aff:refl.nonrefl
zwolnienia	zwolnienie	subst:pl:acc:n2+subst:pl:nom:n2+subst:pl:voc:n2+subst:sg:gen:n2
zwolnienia	zwolnieć	ger:sg:gen:n2:perf:aff:nonrefl
zwolnienia	zwolnić	ger:sg:gen:n2:perf:aff:refl.nonrefl
zwrotu	zwrot	subst:sg:gen:m3
złomowania	złomować	ger:sg:gen:n2:imperf:aff:refl.nonrefl
ćwierćfinału	ćwierćfinał	subst:sg:gen:m3
ćwierćfinałów	ćwierćfinał	subst:pl:gen:m3
łódzkiej	łódzki	adj:sg:dat:f:pos+adj:sg:gen:f:pos+adj:sg:loc:f:pos
ściśle	ściśle	adv:pos
śledztwa	śledztwo	subst:pl:acc:n2+subst:pl:nom:n2+subst:pl:voc:n2+subst:sg:gen:n2
ślepoty	ślepota	subst:pl:acc:f+subst:pl:nom:f+subst:pl:voc:f+subst:sg:gen:f
śmierci	śmierć	subst:pl:acc:f+subst:pl:gen:f+subst:pl:nom:f+subst:pl:voc:f+subst:sg:dat:f+subst:sg:gen:f+subst:sg:loc:f+subst:sg:voc:f
środka	środek	subst:sg:gen:m3
środowego	środowy	adj:sg:acc:m1.m2:pos+adj:sg:gen:m1.m2.m3.n1.n2:pos
świadczeń	świadczenie	subst:pl:gen:n2
świata	świat	subst:sg:gen:m3
źródeł	źródło	subst:pl:gen:n2
życia	życie	subst:pl:acc:n2+subst:pl:nom:n2+subst:pl:voc:n2+subst:sg:gen:n2
życia	żyć	ger:sg:gen:n2:imperf:aff:nonrefl
żydów	żyd	subst:pl:acc:m1
żydów	żyd	subst:pl:gen:m1
